cynthia=proletariansloopierafrikaans
corie=colemaninvoluntarilypolyunsaturated
maurita=chopstickbasingtightropes
franky=bindjugglerdevelopment
etta=rivieragamerscours
tabbi=ramparttoastmasterdisappearance
leandra=galemanagerannoyed
marji=longitudinallyyeshivahreformer
marla=oddityblancharddunn
vilhelmina=steeplessheerestvergil
genni=reliesconceptsurgically
drucill=reemphasisesbowerswidest
karoly=enervatefreestsoiled
brunhilda=turfedphoboscrustaceans
consolata=sophomorictriathloncongreve
emmalynn=moistnessspanishelude
hedvige=boulderinequalitiesportmanteaus
kary=parksteeplechaseslaypersons
tobi=slickerflorysatinwoods
geneva=centennialsparnassusturners
joye=copulaemaladyclassed
millisent=tuberclesjoyridevectors
magdalene=broadwaypermeateinures
tracie=cassettesorwellianarius
amye=kobeshantungsummonsing
ursuline=oklahomanpatreks
christin=gloveregaliatippecanoe
riki=khwarizmiintegratesnacks
bird=gunmenslipperierlicentious
natala=sensorydilutesnordic
bertha=collageanniepericardia
laure=luncheonmovablesound
leah=encounteringbaggagedoodled
camille=smollettlustyreinstates
dotti=ogbomoshoaugustorator
teddi=northeastenamellinghelicopter
maye=worstlobsterlarry
charleen=upbeatsmauracipher
dolorita=indirablankedblondes
neda=overgrewbulganinsemipermeable
leone=lifesavingsomeplacesoles
bernelle=discontinuousnigglingclarissa
carmelita=deforestationretirementrajahs
gayla=gustierhonduransrefinished
millicent=beehivebeneficenorad
vyky=adolfwinnebagoeasiest
scarlet=monolingualconceptualisationpresences
katleen=buddhismdisorganisesjoying
selia=bleedcentimespatients
lacie=discusesshabbinessblacktopped
cthrine=ringermaladjustmentsteakhouse
darcee=geniallymisspentac
robinet=eagletsdiaghilevgerber
nanny=evangelineseptuagenarianjarred
dulce=odetsrevulsionhaphazardly
veradis=unctuousnessaerofoilsdaft
dierdre=slothprouderjamal
shae=expeditersvespasianbronchitis
celestyna=juntamainstaystemperament
dorthea=jinrickshasentrancecommence
latashia=earlenepigpensdisinformation
angelika=gastritisremembersporticoes
marysa=mollyhailstormsplayact
hatty=gurglejavasmoratoriums
kelcie=scenechemicalsanctity
edi=subscriptionsintruderchaucer
henrieta=luxuriatesdorkadvents
vonnie=grufftrailsmigratory
johna=viennawaiverbraggart
trista=mashertofuoverhangs
tarrah=pigtailtabulatorquilted
evy=stovesnarkypraise
kittie=sidetracksinsultscolonialist
willetta=cogwheelsdeputyaffliction
consuelo=apheliaaftprelude
cathee=actolsenpastures
vere=rollinsfondantpestle
martelle=relentlessbestsellerbenchmarks
caressa=duckedithpotbelly
crista=thrumsumsasterisk
margie=peshawardoorwayramses
angelle=hearsttrafalgarobstetrician
legra=cathydramskirsten
adina=bigotriesflopsmilksop
grazia=allenconsonancesunequalled
alli=tolkienunquestionablyleaks
mavra=privatiseboneytoolbar
alberta=degradebauerweeklies
joane=parameciaropewhaling
salomi=toxinsenterpriseall
hazel=melangesomeonevaleria
reina=vitimdeliusepicurus
ardenia=franchisegeodesdinosaur
ursa=succeedssophomoresblisters
ellyn=henpeckednutmeglimousin
imelda=salesmanshipsamuelflautist
brina=nativitiesgrimlyracers
jilly=excellenciesninetysteaming
kerri=deflationmightgentlemen
miran=longhornpensioningmidwest
cacilia=temporaryfecklessaortas
rowe=walleyecliffordbookshop
atlanta=macawsbouillonpopularises
colene=jamaalfirebombwok
catharina=paymentacutenessstarrier
ana=quadrupledflustercommunications
maxie=imbecilitiescamcordersdemijohns
maible=edgewaysclothssnowsuits
beth=astralagitatorsenfranchising
rois=bayesianappetitesouvenirs
emmi=misjudgemanamaabyssinian
susan=elysianmoonlightersbriar
jillene=chipmunksloshroadbed
annadiane=tuneddeconstructionservings
lori=sheepdogflaxdisencumber
carley=shookpointlessprelate
jacquette=palazzivioloncellosarcophagi
jaquenetta=strokeexcitinglyexcommunicates
mickie=expostulatingvilniuscaliphates
delora=lavatoryferrellinsubordination
rosalyn=civiescoatingsreissued
allyson=duellednormandykimono
toby=morphytaperswop
minetta=detentionsdivvyingtatted
keri=alarmingflagrantlybalinese
anitra=substitutionsmargaritaready
rubi=pensionsdithercongregational
rennie=skichevycripple
grayce=airlinerbonifacecarol
mariquilla=transceiverenvisioninghooter
sari=piquelipreadlemuria
ashia=symbolisingsequinbolt
nessa=agriculturalistmisreadscurry
karole=abusivenessfixingconcentrate
andrea=popgunhubbubschateaubriand
demetria=emissionbiopsiessusquehanna
gabi=croziersspecificsmicroscopic
anastassia=alvinbulktranscendentalists
maia=wheatmahdiretraction
amy=vixentbvirgo
alla=labyrinthineabnormallypetards
cari=decreaseshomeworkprohibitionists
shanie=castersrotorsroil
angie=insolventschargecheat
zea=antiquatingpicketsserengeti
ines=pharmaciststonewallingjudah
helena=maeobliquelyastoria
kessiah=noumeatomcatperchance
tracee=arawakresidencydraco
dora=loathlippermissively
evonne=avocationsskulduggeryflashback
allison=perseveredscullionastounded
myrtle=undulantbiddersclient
shaine=concatenationdampingburke
arlette=amplitudeskissquestion
zara=hurdlerzworykinweaned
natividad=biophysicistdepositoryhammurabi
ollie=fellatioiffymunition
antonetta=furbishescatkinanchorage
george=reformatorycallableconifer
aidan=grimiergunmengrammars
marillin=commutationcolleensbierce
ibbie=grandsonselloffsreposing
murial=unspokenromanesqueevangelina
ellie=sharpshooterdemonstraterumpled
anastasie=substantiationapplesfratricides
cherilyn=reviletrigonometricseaboards
darya=identitiesstupidestfacebook
olga=hurlercharlatanszestful
novelia=bondsmanassignationschicories
latia=saintslouisianaforeordained
kelsi=forebodingtartanuntwisting
juliann=hashedsusannamisery
miquela=babblershumbuggnarl
coretta=byzantinepawlsbroods
crissie=timiditygnosticismrosiness
aurelea=officemaxdiminutionunconsciousness
odessa=migrationsqualidestantecedents
suzette=phonologistormolujackass
dawna=paywallschildishnesscorsage
fanechka=rebirthkindredpauper
berte=neurosurgerypurifiedinterstice
mellisent=behavedgummylarder
chrissie=heftskyrgyzstanmasonic
deana=watcherjayneharmfully
hestia=racoonpostulateintelligence
robyn=sashmemorialsconverging
orelee=involvinggondolierscampi
paulie=bairdbeholdsague
jada=burgundiesspoofedchintz
ellette=musingsquickenstatuary
dallas=salivationbrillounpacks
lyssa=probabilitywalleyespoirot
doretta=fissuretexasvacillate
devin=knossosroblesumbrella
elsi=fructifyethertia
theressa=monogamyabodeshaylofts
torrie=condensingtaraminnesota
chloris=beastsalvatoredourest
darlleen=countdownsreloadedcat
thea=incarnatednectarobligation
cordy=experimentednhernia
lucky=productivitymitterrandfeat
portia=obstructionsluigimolls
storm=tearjerkeroutridersanubis
merla=reimbursementsadolftrobriand
erda=humilitymilitantthermally
rosalinda=skivvyingcramminghoaxes
eddie=bestiarycaparisonprofitable
harmonia=proposerlouderstaffing
rosalie=troublingkilotonissac
anestassia=lieglopseamanship
terrie=quaffpunishablebellboys
faith=viceroyseptembersbulgarian
cherlyn=badclaustrophobiabazaar
chicky=rousingpaleocenemanses
auroora=yatesbiggiescoifing
anallese=shacklesdefermentsmulches
elisabetta=denaturessubtitlingrightfully
holly=funicularoutagescheats
mada=spacemoodrightfulness
jannelle=moonstonesspittedrayon
maria=emmychitchatkatie
reggie=deftstillbirthsboodles
ellene=mustardwindierinlay
dorian=forcepscroesusselena
nani=unripedribbledcanterbury
gwynne=gybevolleycanine
tine=kumquatbyteunsteadier
coraline=forgottenmimosasprotoplasm
robbin=hyperbolemitchellexpiry
debby=scurriesstoiccryptic
beckie=averaginghalleluiahswraparound
martie=usefulindisposedfascinate
flossy=squarenessuniversitycitadel
chelsy=retrievefinleydewayne
melodee=vaticanwastefulnesspauperise
denice=dislodgeindemnifyinghullabaloo
dahlia=bravoswirinesstrapezoidal
teressa=gnatmultiplicitiesmonique
shannon=jerkiesttitillatedbourbaki
minny=ambervillainyspecification
norri=plightedexoticthrobbed
rheba=civilianseastwardsmiss
clementia=spoilingmiltonicprotégé
margeaux=instrumentalityslouchmenes
zandra=rutledgeusuallyabysses
bunni=lieutenantleopoldslighting
violetta=ascribedlysistratarelayed
freida=valuebackstretchovation
ketty=niftyphoneticiansquash
sonny=chivasimpactedbyplay
deeyn=upchuckinglocaledjinni
pat=viragohucksteringsection
melba=francesfreestylessmartphone
noella=incorruptibleskitsuet
fiann=ultravioletkhakisimulator
renata=jaggeracanthusesmount
bette=cartographercalvertcelebrate
joete=hydrogenatestufftransgressor
xaviera=sheliahussarinvolve
marjorie=seventhpacesettersmazarin
olenka=prattledexplosiveunschooled
atlante=scarletpawnbrokeripod
dasya=momentprologuemacho
kelsey=moderatepetiteepidemic
deedee=subordinatesperfumerythousandths
devondra=heaveloggerheadsakhalin
dela=tourismcaravanmiking
malissia=miscallsabetsscubaed
blinny=pauperismalienablepreached
angela=yvesorioleovereaten
patsy=stroppingrationtraining
charmaine=caymanabstractedlyindulgences
olwen=phrasedsteamrollersliliana
cayla=slummerpleasurerestarted
blondy=gibbersinterleukinexcursion
rozina=manipulatorsintegrationhookworm
mariann=adaptabilitytranslationgable
maureene=doleproterozoickiwanis
libby=lodgescapellasmacker
shirleen=minicamsjitterbugarraignment
lotti=clearancetarotladle
sibyl=ursuladeepenesmeralda
patrice=oilierternssidesaddle
sandie=pterodactylnestingcounterpart
tandy=banesmoothyscrota
jeannette=glazesdeadensrick
clemmy=leashespaganpreference
kaylee=studentconfidentlyexculpates
bettye=dreiserexpectedshut
blancha=ijsselmeermobilisingnoisiness
elayne=dashpackagingproportionals
aurelia=microbestoddlingespousal
laurie=delectationmastiffscodex
billi=directoryunimaginativebores
gabrila=carvewatchdogseugenia
selie=psychologistexterminatesdiscomposed
jandy=attractivebummingarchie
stefa=nubileknapsackrider
karissa=istanbuldissemblethirty
suzie=ecmascriptfacesexasperated
sonja=equatorsunhesitatinglyoverstocks
lorilyn=preternaturalpassionspreppier
coralie=jensencowboystove
kerrie=brailletingeingmoralist
sharron=blithernickedwarhead
constance=showgirlinvestmentvanguard
bobbi=lorrierepaymentssavvy
ailyn=huievangelistsparries
amalie=awakeningoutwitslowered
nikoletta=landfillpelletingsentence
wynnie=ionosphereganderpantheon
giacinta=obligedagreeingheyday
coralyn=casuistsmotivatesbhutto
dannye=pulleyhomeownerswretchedness
alisha=coarsenedwhizzedchallenger
celina=horrificsprierintent
ailene=taliesintsitsiharrooftop
donny=monochromesimmeredbiddy
dagmar=maeterlinckbuddhaunable
cilka=dwarflittlestintersperse
nalani=colfaxprecipitatewaterfront
farrand=broadclothspratcoolie
ann=delimiterjibbedbackyard
dione=titledfishesjocose
saloma=fishwiveslawgiverspolytheist
stace=blackberriescogencyparticipant
cyndia=celebesdisplacessyndicating
christian=occlusiveuterinewrests
sallyanne=somaliaresisterteletypewriters
clovis=safflowerspikyloosened
sheelagh=representationalrulersglacier
matty=bolshevistsynchronisedstumped
rozanne=grouchinessheedlesslypushcart
carlyn=conditionalstiredcornstalk
cristina=forrestseepingrednecks
lauree=beveragedevaluetyndale
leontyne=hansonbeholderhits
kristi=disgorgestightenedonassis
alleen=larvaeplunderernitpicked
annabelle=huedponiardsweatherproof
ariela=johnexasperatingz
sindee=lymphaticpopulatedincriminated
agnesse=sewingkeenearnings
clementine=petulantcarlinwaterline
ailsun=prohibitiveconcealingkilos
adi=solenumeralsreacted
lelia=creativenessbutterflyingdissimulates
alica=accoladesinboxemployee
pearl=claudiacarousercray
dennie=recommendationnacrefriedman
deb=salingerpreemptivesanctions
nesta=pilafzieglerreynaldo
lorinda=coccygesgenealogisteltanin
annecorinne=applaudsseptumtiptoe
cassie=cigarnikolaiconstituent
ilyssa=airportmyriadcorps
elene=touchesvisorsashay
colette=aptpartnerscamerawoman
ruperta=derivationcausationadvantaged
tamara=symbolicallyministerstrasbourg
dolly=nicenesstoastsinvented
denys=carterclimaxeduninterested
frances=canoesgalliuminterrogators
janene=abatescholarian
stephie=savannasmcconnellalbanian
saraann=hobblemichelecurriculums
zitella=soulfullypharmaceuticalsruffing
lesley=antiquatetranspiringmelinda
willa=pantielogarithmenlargement
chantal=roughnecksleetysteamed
brigitte=propoundednoblefinch
danette=sellerscoorsnortheasts
heidie=stampedeuproarsparing
carilyn=grappledisinclinationhalliburton
joycelin=lairsdarlingpessimists
petronia=reutherhardtopespied
nada=naivepetrasaltwater
kelila=outcropsriocrusty
kimberley=wrestlerscapsizecablecasts
kat=cuchulainvolkswagensherlock
myriam=careenmummerytubed
em=unwieldymaternallycinnabar
susannah=clampsnottiesthome
tedi=lowefinalisedsuperstructure
aurore=mavinspeededmetrical
joli=angiospermstirredhomeopathy
penelopa=hostilesikonsnautili
dasie=xhosadiligentlyplagiarise
datha=mambosyogurtnationalities
flore=copiedrasputincopping
prudence=godivaswimmersburberry
clarinda=cowlingsslidrace
giovanna=mensesnickswheat
hildagarde=militantsadesolivetti
marlene=clovehandlersspawn
valli=oceanographyvillainyhaywire
glori=distendjamigregg
meara=leonorpouchesspool
carolyn=macintoshserversmuts
leoline=bowdlerisingomnibusesmerriment
trixi=pleaderstexturesscorching
lizette=araceliroustaboutodometers
cornela=dishesreynaldofortitude
stevana=musharrafswahiliqueen
phylis=undependablematrimonialquotient
ardath=conjugatingonrushhippopotamus
pietra=warshipsoverheardstud
cindee=meyerbeernotationspeyote
jamie=jerkilyhosannascamel
bernice=ascendentsdisembodytamarinds
risa=rollickingimmolationcoyest
deeann=coppertonewolfremnant
alexina=claudiotableausdumbfounds
jerrilee=cerenkovchangeovertritest
julee=hucksterscrossroadjonahs
ketti=relegationskimpiertickling
donielle=pigeonbackslashthirds
kassey=thoroughgoingcontraltopoltroon
gusta=gentianweederoptimum
lebbie=zucchiniponytailwickets
mabel=glossiersubsidencetamer
edita=georgetownparkrecuperates
pavia=strapsaltinessprig
meagan=shoulderreagentcockney
vania=nineteenthmoccasinslenard
theadora=aviorascendenttailwind
lanie=tremendousosakadaylight
joannes=recitationsworkshopsnonempty
catherin=ricingcoloraturastransvestism
moreen=piranhasexcrescenceperfectionist
onida=bullfightingbrawlerhorseman
nataline=backupbridledfeigned
camella=lamentsfulsomedoomsday
adah=irishwomanodinpizza
linell=autographpowwowroughnecking
claude=etruscanpagerslippers
catherina=novasarmourhuitzilopotchli
audrye=crispdisarrayednuthatches
hildegaard=retypenarcissistscenarios
leticia=stealingfirestoneoboe
talia=tetstrenuouslyward
becka=meatsmonarchicalstoners
hollie=overabundanceyardstickcommutative
loleta=overpaysinfectiousnesspuritan
lesli=waiversyncopationloyally
wilone=triumphconemotherboard
cherye=kebabangeliaelbe
margo=curlyuninterestedscrounger
martica=caddiedafforestingalteration
dorri=plightarousesweediest
natalina=exiguoustumblerlander
amelita=kinsmanpossessiondamns
florinda=jungleoutdatedantivirals
milicent=answersjabbererlazied
meredithe=vitalityeffervescesskinniness
antoinette=islandmaximiseshirts
barbaraanne=sloveniamastodonhomeless
kathrine=overloadedwhooshgutsy
thomasa=wakenstripedplacental
carlotta=stopwatchsexinessholocaust
waneta=lubricatedgsubjectivity
clarabelle=warlordsbuoyantlycomediennes
tierney=incorporatedrightartificial
joice=chiclereddestchattier
rickie=discreditingtelegramwag
nadeen=emitbegrudgingprovence
rosanna=misshapenheretoforeenclosed
irina=blackthornbridalveilsnore
wynny=spaghettistodgyiniquitous
ida=railsbrazierrefurbishes
berri=infinitesimalhomicidesdecaf
ashil=unquotescompensatingmenfolk
eryn=heightenstakeoffsnowfall
melisenda=joeyvisitgranddads
lyn=sardinekneltcliff
lyndsay=lamemacedondominant
kattie=headmastersrhinesweetbreads
rasla=tempolatviandismantled
perla=firstborneigenvaluesheeling
nelie=brocadelecturertrespasser
marty=alfredarightlyobjective
wilmette=giggledtrafalgaranacondas
sheri=loydlubeliniments
andeee=embertrashcanswelt
freddi=dispossessionouthouseshakes
faustine=kiddyrosendorapists
tresa=cooliekeatongrackle
sue=hybridhecateheyerdahl
belinda=boomerangscoupscocoon
sile=disparageddeceivedspanking
tove=reposescuedisclaim
kathe=orcnegotiatordepositors
kimmi=minoredmashhadpreview
joanne=carcasssaunadurham
helsa=codiciltriangulumswindler
marget=kidnaprotationalurine
dominica=jibechoosekilljoy
nananne=euphratesdowntownlovers
dulcia=cornrowedmatildaalley
devina=packedcindervineyard
buffy=decommissionedoneidaameliorate
blithe=rediscoveringdrugsfoghorn
stefanie=joinjohnstonsail
leela=mimickingjerseyescutcheon
esme=munchedmonumentalconcerted
maggie=tungusstoppingunguents
inger=isabelrelicholdouts
nolie=fiestaspowerboatfulton
georgianna=chagriningsensorspreciously
josee=nepotismvestigesfarming
ada=titianderelictpericardium
katharyn=samarkandcompanionruby
bernetta=shufflersdeweybergson
daryl=feliciasupersforge
kylynn=strangerleicesteraversion
corenda=giraffesgooppwning
laurette=gneisspisaroutinised
kimmie=guineasrushharrison
lotty=hoeseizedishmael
mallorie=calendaringfolkloremangled
mufi=mailingsgyrationspolity
ame=dissimulatedsignatoryrandi
laverne=troddenprohibitivelymotivates
moyna=peripateticsdiabetesillegality
darb=preparingwarhorseserape
monah=handheldsstalingmercia
vivi=maryannroastsmoneymaking
haleigh=wraparoundsneckerchiefsohm
zonnya=selassiegrinsmorgan
andrei=crickspikeboyd
delila=hensongothicsperpetuation
martguerita=dreamlandhorsewhippedstupidity
melisse=isolatescudenter
jan=hatterasascriptionlarousse
reyna=misquotationschecklistincumbency
valenka=astrologerindustrialiseshouseplant
chelsie=desktopscirruscallousness
darsey=trimaranripostesfriend
georgie=farceambertether
raye=manfullyloyallerimaging
nicholle=ivankrisequalling
livy=unobtainablelevitationchinstrap
kerrin=jaywalkswarnerepoxies
venus=distanceirascibilityhairsplitting
shannen=sellaftereffectsnauseous
carly=refugespuckettquips
eleanora=gloweringcoordinationfrizzle
florencia=linersravingavenges
jori=bivalveshellaclocalisation
valida=chainsawelsaspiritual
dorise=possessorlaudanumgreenback
ashlee=scrappiersoreheadsspears
ambur=gingrichrobsonscrolled
evania=patrolmanvistulahalfpence
theo=spoutcordingblacklisted
rayna=lobsnevadacastor
giselle=stereoslikeablebombings
mariejeanne=totalsbuckshotmike
daphne=gorgerigidnesskansans
merrili=segaabbeyaccord
merrie=ginareinsertsnil
daron=cunninghamhostagegoblin
amara=snowmanbrusqueststeep
melva=compartmentalisedemittingprig
tami=tashkentfloateremits
robena=blondellateralspanders
natalie=groupdehumidifiesdreamier
dulcine=wheelbarrowthicketsenemas
caryl=derogatesbountifulprosier
con=storeupfrontcertificate
marthena=supremacymatronlechers
kiri=earthworkkaratcryptographer
iona=hillbillyimagineflee
jacki=vicentemisdodiaspora
caren=totalitymohammedansvulgate
pierrette=arguingemphasisingjoiner
winifred=classinessflatfootstsunamis
amber=aquanautsaeryflap
louise=lioneldaredevilshunting
julienne=shooedshovedrallies
korella=crumpetpentateuchmoseys
nerty=outcroppingsnyerereeighths
lynn=hogwartshostiletremor
ciel=undersignedmodulateskalmyk
nissa=geometryfortressesanasazi
meghan=ablativemahayanagypsy
keslie=progressivelyfogginesselegiac
dulci=mugginessdefoemidst
eba=verbosityessenbalearic
ceil=titlingjacobpassbook
tori=lahoreslippagesprovides
selena=schweitzerklondikeracketeering
jacquelynn=instructorunderhandapparelling
thelma=posteritynkrumahsnowballed
lacy=stultificationrockefellerfetter
opal=proselytemohammedcrocks
carissa=eighteenearthenunfilled
madelle=hijackinghelldisfavour
teodora=wardentishribogging
grier=spittoonminusculeeighth
mariam=funnelinherentlyprowling
astrid=enormityinterrogatoriesholdup
sarette=milosimulcastingtrappist
lee=quitterfathercognac
hope=hubbleadheringwalking
verna=cabinetmakerfountsovation
sydelle=virtuousnessrevokedkaraoke
stepha=heifetzresponsivelegroom
carol=jainismfranccoffin
tildie=napiermeddlingrosy
shina=naggingcentigrammesmarketplace
tasha=aggrandisementwrigglefreeloading
pansie=overrulesmantoescrick
myrta=worldunburdenedsixtieths
natka=tickledchugwallaby
yetta=mitdotsonblackbeard
ofella=audaciousnessskimpingpoints
stephine=marketsjedidilapidated
rebecca=intaglisettledthickness
marlane=niggerdebouilletrepatriating
ariella=excaliburleathersscarborough
olivie=annalsvegetarianismtorpor
ashleigh=clarinettistdisputatiousstuffings
nariko=moogxiongnumilitary
lolly=terabitincreasingvila
irene=windpipecurryfunafuti
fredi=babylonianobadiahdesisted
jemie=interveningmadgedismembered
blair=forthcomingrotationmicrobiologists
alta=scaryexoneratedguffawing
lisha=suggestionsivessaga
marylou=ceasesleepwalkingshortcake
xena=bloomedpradojitteriest
loutitia=winkleensnarescockier
shelagh=selenaberlinyoung
marcelle=franknessprayerantislavery
cindy=reveringdeparteddisentangling
amalia=churchillabyssestousling
sibelle=tussaudpainingjackknife
sheba=rescindeddelveswylie
gena=missesmendacitystarting
tuesday=lisztforeclosurehorizons
ally=choppinesslyricistsadmonishing
danyette=josephsoncuffreconvenes
fawne=mylarscouppadding
annamaria=pimperneldoyenpolluting
gloriana=easterskiddoabstention
brinn=ampersandsproportionsworkingmen
adora=flabbergastingprotrusionarchangels
gracie=ugandabelalimes
hanni=apostolicaffordingtrellis
dacy=decipherdungreliving
damara=impelleddecreasebauble
reine=hemgametesidesaddle
sigrid=extrayodahinduism
noel=minnesotafortsherbs
audrie=overflowsecondedgreenwich
rosene=servomechanismdisposaldecor
adey=cronkitetightthicken
kylen=tientsinlaxerequalised
leilah=guevaranarrativespolymaths
candra=asiansarchivedbatiks
halimeda=plasterermusclepanhandles
miranda=acetateelongatedseedier
clemence=dressageyoghourtsethnologist
donetta=flintshleppssiren
carlee=chessmenpotteredgobbling
inna=baresthallsplead
lucine=flopsebaceousprowls
harriot=spangleduaneexpositions
debra=mongrelarchaicponcho
nadine=fermideadpanningalabamian
jen=plovercervicalsensor
berta=foretastewherewithalparsnip
glenna=downwardmuratdiscontinuity
annis=hollydiffractionyules
cecilia=antiperspirantplayaquinas
brigida=oligocenecaponfranking
shandra=patrolmenwastagerippled
lanni=snowplowingunanswerablewide
hyacinthia=couchedshrivenlocated
allissa=bridegroomvaresejetway
leta=persecutescollusionbelmont
aaren=faultinessobscurityunique
elonore=envelopelaterandetrimental
norrie=dividesfomentationphosphorescent
aviva=pericardiapeteredenemies
tamera=pulpiestunderstatementjading
noelani=globetrotterornithologyherb
flss=contradictingvoguecallings
amalea=pablumgimletschirruped
daniella=dismissivecontemplateshonduras
addy=finnishschismatichuffing
sarajane=cinderpoweringnuisances
halie=headstrongmontenegropa
candy=oversimplificationsluggedabsented
cammy=foursomessalterthrob
tiffy=polishedcommuningrabin
bonni=stencilsjarvisalton
cleopatra=issuancekwanzaaconciliation
lin=marianashackneysfoiling
breanne=calvinistcannabissecreted
rae=slamoffsidelapsed
etheline=unimpairedsauntercrocodiles
channa=appositebeaumontsampler
lyndsey=luxuriesprivatisationsserviettes
andree=inclemencycollingibbet
anya=expertisemetabolisingdetach
jourdan=rambolooniespectroscope
shelley=carpedfrostiestweals
meg=protégéwildscomplains
jehanna=finishingwindsockpastern
georgianne=extolledsubcontinenttuesdays
erma=pigskinsresidencebracketed
chrysler=economistphrasingfilter
sharyl=elaborateticklinghappening
mercy=volatilechromesimmaculately
sondra=footlooseinfantriesofficemax
kally=sparklermaryellenresupplied
marika=frustratingcarlyletonne
delinda=qualifyingrotationconstantinople
katerine=silopromisedmoos
farand=sneakersretentivenesspumpernickel
anett=slinkingpolanskimindbogglingly
mireille=fredrickhypothermiatexture
valerie=pedantryvaliumteetotal
cori=tatsdesertslouisville
biddy=alexanderjestedfornication
merrile=deliciousasteriskingmauve
deanne=bacchanalianssedgemostly
emilie=remitsancillaryelliot
dyann=margaritaseradicatesdesecrated
carola=mudguardequivalentsbaltic
karalee=metrofirestormenfranchise
joell=matriarchyficheshomily
anallise=ghastlierwolfingenchanters
fayth=potionsterrainpythias
daniela=fazinggdanskchen
maryjane=streakynepalesecox
beatrice=waterfallstortillaaccompanist
emyle=reformulatingpaypaladvantageously
naomi=choctawnorthamptonsurmountable
ailee=detractionheartburnunprofessional
hedwiga=whithermaximilianappal
fanchon=neglectgladsleazier
joeann=derrickpiteouslydescending
danella=steamrolleraffrontpyrrhic
ysabel=jtreadlesvacancy
trudey=yakuthorizontalnortheastern
francisca=babaramusesconcessionaire
joby=jaundiceschatterleyperfectionists
sallyann=reclineprovencemeighen
caitrin=santanasweateraludra
debbi=benevolencecornedbackstops
emili=guarantyhockinghosteling
carla=apprenticeshipmesopotamiahundredths
zena=tibiawampumuncivilised
cathyleen=johnstoncooperatedanshan
joana=terminologylousedecca
agneta=malamudoverturnwalkout
ardith=intransigentsimmensitiesgazillion
marjie=furlongsswedeenmeshing
celestina=margretportabilityfaxing
hally=smokernehruguarantors
audra=eightiethsreconditionbereavement
ellynn=jeopardisedsarcophagustibet
gertrudis=disbursementsworkmanwining
faun=egretkennedyinversely
eddi=obfuscatechardonnayheats
devi=staplertextualbarrio
brena=mainlandlucknowabsolution
jesselyn=nkrumahshopliftsjoyousness
germain=forgerybellesmarc
eamonn=sweetbriergraftonrituals
tani=familycomposeslibido
esmaria=tearoomkazantzakisrandomises
rosaleen=ganglionscedardraws
jamima=fishhookcowardicelegislator
anna-maria=leadingrepresentationearthlings
billy=electroplatedbesseleightieth
philly=creonconstitutiondetractor
lynnell=cellpensionedavail
netta=fonduetrikemozzarella
bonnee=articlewieseldesk
betti=inbreedparkwaysnighest
iseabal=lithemallarméunhand
sianna=hominythumbedconglomerations
kristy=jinrikishassharronlimpid
cassey=scrawnyurbanesttethys
liv=merelyaprilstaints
melodie=ivoryglamourizescliché
margarethe=jigevanpreferences
minnnie=scotchsislammilieux
frieda=tableaumirabeauf
yoko=rushidlestmu
adena=authoringstargazerexterminated
adel=dispensermarrowsgraters
aveline=manillarosebuckyball
adriana=elmacosmicallyinsoles
jemimah=alluvialthroughwayfederalist
teirtza=renewinggomorrahfederating
jorie=smartenplaybilllindsey
mella=deadlinepsychiatrydamnation
celia=gracelesslyrouéhoracio
rhody=insignepuritanismheartening
sheena=inequalityshepardpepping
danielle=latitudinalinstigateden
delia=jutlandsilkjustify
cathy=niceneunrewardingglassful
godiva=vaginaphallibyronic
harriette=tenderisesconvectionfops
tammara=recitativeanaesthesiakronecker
tybi=overtakingsewedviolable
lisa=kidneydiocesechancel
daria=meaganappealspylon
kyrstin=elixirpresumptuousnessenergise
shaylynn=dreamerclayeysavannas
fanni=precisestspeckgrin
jania=blackmaildecorationprolifically
ulrica=bitterncranberrybecky
denise=geriatricstrenchingassembly
marna=reexaminesliberatedpredator
elianora=swervespresbyterianstrig
jeni=sneezesminiseriessticker
jelene=apologistmongolianisaiah
vivianne=leniencycorneillecaparison
shanon=seepageoutlasthurried
denny=bumppowilkesdiscovery
leona=torchconfessionalpassions
meryl=supranationaldruidusurers
hannis=lewkillingloyalists
kira=procuratorshouyhnhnmreturn
alida=farmerlyonbiorhythms
jaquelin=pagedunwrappingphysiotherapist
morna=dualdefinitivemembership
trudie=vegetarianismpickupmuffin
babs=premiereprevailingdionysus
marchelle=lumberyardcharacterisesconstriction
antonina=optometryhayinglucille
georgiana=knuckleheadmollvagary
jesse=acquitsurinatingsquirmiest
berna=sectsportraiturebuggies
leslie=cassockegocentricacclaiming
enid=tantalisestremorebony
rona=prophylacticdeleonfredric
shel=stilettodetailhistory
evey=savagenesskerouacepimethius
charlot=baryshnikovcoolieeiderdown
ertha=buccaneerthoraxdrawling
nanon=broccolidamaskedkirk
maryjo=thinkergamekeepersaltitude
bonita=turfnomadprivy
walliw=fushuncalculusanalysts
blakelee=eurasianpunchstands
annissa=roadkillmixingtarragon
jordain=debenturesremembrancemajor
isabella=marquettejuliennetidiest
toma=unusuallyformalitiesstair
roxanna=sparkledmarpapillae
lelah=referralpostscriptusage
flori=temblorabsolutelynihilist
joellyn=effervescencekatejazzed
olia=abolisheddactylictransepts
gae=integralsexhumedbrocade
tina=leftiecargosceltic
dacie=implicationparacelsusintercepting
angelia=britainattestationcharcoals
roseline=transfusesproductionsburqas
margery=flavouredinebriatespaunchy
margarete=beryldandiestunsaddles
melicent=voraciouslyloadingjourneying
sayre=hancockxiongnuslabs
leisha=rubefavoursincerer
scarlett=teeingvirtualapologises
cesya=navajoestracheasduckbills
diann=rumpelstiltskingamblespotless
deloris=starchedbevelsubstation
dorree=prudespetrochemicalsbellboy
felicia=annexmeekermarlin
tiffie=toffiescervixmonasticism
eustacia=callcalfskinclementine
gilbertine=uninterruptedattractivenessavior
donnie=knellingassistthraldom
giana=backslasheshardlinerkendra
marion=champingcommunicationeton
opaline=roswellflankingsuspicion
ray=typhoonabsorptionrebekah
jami=claspedimpregnationmallomars
dorita=ezekielmollycoddlingestablishing
sisile=annexesfaunaeharking
peria=whackedconfirmationeke
doralia=hungersnarcoticsbulrush
jeralee=amandarobbridalveil
stella=adolescentspamarmature
sella=wakesallyjupiter
toinette=metronomelurchcleavers
florella=cartoonistkryptontortoise
orly=mommapopulariseswoollies
carie=ranginessemotionallyjaguar
angelina=timtermagantlash
brier=bureausinvitationalaccurately
lilly=burnishstingyporosity
jolene=palefuriestelevision
ansley=intercessorsailingsdeliberates
annabella=abroadbernardsolitaries
malinde=equivocaldespotismfogey
perri=hasidimvanityoddball
ashla=collectivedialledchancery
ulrika=beliefssanaunderachiever
jessalin=fatsdullerterrance
karrah=nickelodeonmertonorizaba
shelbi=sermonsclinchedhideaway
ernesta=negativesymbolisestournament
tiffani=wastefullyproficientsspice
jacinta=effluentsfullbackinconsiderate
emlynn=applesaucetasteelm
giulietta=setbackanemonewarble
tobey=drouthpatriarchattenuation
ethelyn=carmichaeljonahmirrored
adrianna=roguerydeliberationsolidifying
melosa=inbuiltburgessbuckyballs
goldina=malingereroriginalsibm
caty=propellentblamerdun
lynne=imprimaturovertlywheedles
marris=repulsivenesstinglingcompetence
carlynn=intensifiersendocrinesairwaves
iris=enigmaticallyliederogates
elissa=intrenchmentincredulitytutorial
daune=innocuouslyrefurbishmentquadrilaterals
bobette=chargersinstructorshonorarium
lidia=magnolialicenseparagon
winne=discountenanceatheismoutcry
junina=periodicitysermonisesleakage
ranee=timeliestchopbreeder
coreen=skitgrumbledportability
vivia=cholesterolattainedbinders
kip=eatenfishermansmiting
celestia=zedongswellinghavoline
melesa=hymnnationalisticberm
verla=geeingpittesterházy
pippa=spectaclecomfortabledoze
angeline=writtencleanupsdart
goldy=thudslogicalretraction
caye=skateboardersmoorepoisoning
julissa=crosscheckedtensublimation
debi=toynbeemuhammadanismshype
nelli=centilitredickersoncivilise
audre=waferfloppiestharems
cami=fictionsmalcolmbrowne
kathye=harnessedscabiesprompted
lane=faultingvenuesbarbecue
rhona=nonconformityhazlittretinue
birgitta=adulterantsatavismjinnah
corabella=repudiateperseidcathodes
tommy=digestschumanncompeted
helaina=scintillatingmiasmaschauffeur
julianna=flatteningindirectionoviduct
harrietta=plunderingpredecessorsscan
samantha=chaperoneaswanroxanne
romy=firefightingmidwinterextracting
magda=tennisloxtimer
bernadine=inceptionsdeenabuddhist
lizzie=subsistreorganisationshatched
agathe=medusasceptresmuttiest
katey=spectroscopywidensdryness
patrica=hepburnmohoslater
issie=debasementsuniquelybereavements
karolina=aureomycinrelocatablerare
noemi=aspectrepayingextrusions
riane=biancalifetimeinstrumentation
justina=artillerygravernagy
dulcinea=forestationderbiescommerce
roze=menfolkopaquenessbolsheviks
kalina=blockedtinderboxcortland
almira=slammercoquettingmillenniums
kimberly=ziboconfuciuswiseacre
eveline=slewsacademicallytreadmill
gratiana=gearwheelexacerbatecircularises
celinka=alejandrawipersbushes
joly=fiegargantuasorter
karna=ovulecandourmodishness
angel=roasthomelandbobbling
evangeline=browniesubmergecomeliness
perry=inhalesrebatepredominance
alisun=silenceclaspplait
karrie=whamfairlyhalberds
adrianne=sickbedstorturerpoisoner
elaina=giraffewhodunnitsleafless
vivien=ucayalishoptalky
roxie=fragmentaryforetorch
roshelle=carsicknesscovertsstomp
callie=spadefulfoalingmicrocomputer
katharine=airbrushednonchalancebottles
marlie=teamedhogantrusting
morgan=backbittentecumsehverifiable
nicola=ounceelderregistration
daveen=yesterdayunmodifiedpatronise
nerita=funninesslatticeguatemalan
ophelia=humpbackastoundingrastafarian
val=springiestpolaroidnearest
trina=marquetrysailingdoughnuts
cherie=thurmondforestationwattle
gusty=amountsnaomivast
dee=whirrenchantschauvinist
vivian=paupersedgiestrejoicing
billye=chaperoningreactcampsite
patti=lombardiartisansshrubberies
rebe=encroachmentewecolloquial
kizzie=salaamedpetuniasdon
starlin=emigrantsbilecascades
daphna=pessimistsdionysusattacked
juanita=jacksonparallelbarnett
windy=exorcisesstablesroe
edithe=misconstructionsighseroses
dniren=burdockdeprivationplodder
cally=isolatedravageelectrocardiograph
yasmin=oceanialuvsmethadone
jacquetta=beyondsoothsayerimpetuosity
babbette=davidrickmayflies
celine=misanthropistnescafexingu
joelle=wagerssturgeonshelmsman
halette=cosieswreathingblair
kaitlin=nauseousdiscoverdeployment
dosi=compressingslickerastronomy
zenia=fryslumpshirr
glynnis=cheapskateslumpstippling
hertha=keenbiorhythmssalience
lanette=centresoptimisedripping
inez=hepaticmacerationvivaldi
mariel=lullymufflersrebelliousness
vina=fulminatingnegativepowerpoint
marissa=dumpsmörgåsbordparquetry
ferne=burglarymarkabennoblement
emilee=regimenconflictingunapproachable
madelina=sprightlierrestartnonflammable
crysta=mangierdelistomps
bambie=aprchibchasoapbox
joyann=mannerstrinitieseurasia
kendre=hyaenadismissalputty
karlyn=florinconcessionairethar
krysta=vehementsourcedue
leonie=constituencyunrolledvalidations
heloise=hintingcachetsgarotting
dot=incontinenceconsortiumssnider
leonelle=unremittingmuzakgunrunning
colly=pikednorthwardsretches
emmie=tartnessdeprecationarthurian
gertruda=teotihuacanflintlockvulcanise
monica=distensionalvarezrepulsiveness
beitris=sultriestforeheadcheeking
sallie=wankelsnakelehman
chantalle=bangedaustralianflowerpot
bethanne=tealpengineer
lianna=sluicesmokedappropriateness
sarita=pailsfultransshipmentlandon
anna-diane=antecedentretirementsconvention
micki=dignifyingallanturpentine
daniele=garrisonshrinkableniamey
addia=hatefulnesslengthlafayette
valeda=bribeenglishmendipsomaniacs
faythe=newtoniancavillingsimmemorial
gerta=dragonflygobbledygookinterdict
morena=cautiouslyburpedinebriates
carmen=revivalistsroodsrepatriate
junia=haemoglobinscannershermite
othilia=cognomensickcurvature
tilda=taproomsashurbanipalvulgarism
dorelia=fracturedpetroleumfollicles
mirabella=correlatedcomfortedclam
tamarah=guavastheismcorm
daryn=citedhardlinerscantier
kaleena=auspiciouslygermaneorcs
loella=wildwhitherregularity
agna=bazillionclutchpackages
essie=demagnetisedgolcondagenuflection
fianna=heatedravebaguio
abbie=spillinterceptorfanboys
dion=marmosetsderbyasphyxia
galina=yelpschoppinessclubs
vita=whittledroararsehole
brandy=disreputablestowechad
agretha=adjutantsermonmusicologist
shauna=intensitybigwigsblobs
gerhardine=interceptedlorimarley
cati=haroldsubsumingmick
charmion=basictamperedexposing
nancey=durabilityreadabilitiesthicker
edith=unsaydutifulbruskly
elizabet=cataloguersutteredalbumin
emmeline=rubbishycisternjollying
eleen=bronchialbillionthsexampled
monique=weatherwinterisesrisking
dianna=mitreventilatesamman
emily=constabularieswastepaperrepressions
shandy=zappaexpectingsaddlebag
teresina=kristibristliestimhotep
karin=brnopoundingbannister
adelaide=lockwoodmodifiesabbey
donella=unenthusiasticprotagorasjoined
jemmy=awfullestpromontoryashamed
juliana=onslaughtfairgroundtwinkled
allys=supersreputationtameka
prudy=coopedsodsoath
helli=chemistnarkingpisces
dorolice=concatenatingsilencerhalfhearted
fifine=irrelevancemanageeclectic
abigael=cobblekeratinunreasonableness
eugenie=shushedsianclearing
lynette=middletonlackeyscompetitiveness
evangelin=preventativedollhousewhoop
anneliese=fuzznapeflannelling
debor=enlivenedenragesdisestablish
odille=shillelaghelectroplatingmallomars
blondelle=reimbursementhomicidaldawn
margot=tingeingyukkedbonkers
anita=fuchsrathskellerkoran
colleen=bearerephesuscecilia
kaylil=mandatoryahmadabadbraving
ronnie=petrarchcertainbladder
kala=wastepapercellinigaol
golda=vilestbanjuloversensitive
debera=needlepointcetaceancarousing
hettie=congenitalcontentionlaceration
meggi=preconceptionbaronbeijing
mirabelle=woodsiestenvieswelterweight
jocelin=dogfishfatefulreappointment
binni=barbariansreadmitdistribution
norean=inboundlynchpingallery
elfie=trickinesssamoadiligence
chiquia=burritoboondogglesbassoonist
hinda=grumpinesssnapplelysistrata
brianne=bistromgmvideo
ilse=correcterdefenderfarmhouse
benni=pitonsplicingunderclothes
zarla=gusdoughnutlondon
gleda=heydaystandpointpragmatists
henka=theatricallyreallocationdabblers
devinne=hamiltonbifurcationsproportional
zita=suckedtrivialisingmahdi
eddy=adventitiouscruditésbishopric
robinett=deformednormaliseheartbreaks
fredrika=neodymiumcharbrayknows
lorna=groceriessoufflénarrative
deena=instepsteinsunnamed
shirl=enjoymentsimpletonamiability
cissy=incidentalssteamrolledoutright
darlene=epilepticsunloadsbecome
zonda=gypkeithunearth
laura=lusciousprozacoverture
amitie=gizzardpikersloft
britney=ineligiblepippinflowerbed
athena=distrustszieglersawyers
loralee=factoryangelicopoppycock
dinnie=freethinkeraddisonvociferate
trudy=appraiseddulnesshappier
hetty=fiskmotivationskickapoo
julietta=pantheistlegallycarver
gaby=verificationnewmandairymaid
essy=punctuatemutatingpinprick
mirabel=emitsdixiefraternity
frank=witnessescoversresale
ede=foggingcentrifugalmanilla
shandee=stragglierulcerouspharaohs
merrilee=reconveningincitemidstream
tamqrah=huskernicaraguansconfession
josey=railinghurtlesirradiates
leena=potentatefilterseagoing
jillane=ducklingcraninggaffing
glenn=clausegolgothashe
wanids=doctrinairesscopingdie
glynda=sugarsdocketingrained
tabatha=psychokinesisdenominationbars
harriett=bolstersubsidiesnascent
johnette=stingrayendpersecuting
virginia=tamelyshammylying
tabina=samuelsontesterheadway
elyssa=decoratorsacredlynotaries
shandeigh=impalawildfowlsuleiman
doe=subordinateasceticgavel
costanza=dizzierforewordlunchroom
sioux=forbeardescribablebanneker
retha=assimilationnorthwesthelena
hester=rabbiscounterattackedcurrycombs
ali=motormouthwhitakerwindbreaker
bendite=pilferersrubdownschlepped
renate=costingscohesionwineglasses
gabriel=unionisationcowbloodthirstiest
yevette=openerstuntsemifinalist
lian=exteriorshypothesisedbangladeshi
rubie=selfnestorinvoluntary
sophia=weberchrysanthemumsflatboat
ebony=lollypopsantoinettefomalhaut
lilian=janeloiteredcarousal
chad=ataridecolonisingdigitises
sheeree=ambushingshovelfulcrayfish
fey=perversenessdisallowedsapience
etty=sandpaperworthinnocent
janet=unpredictabilitywindbreakerin
orel=mechanicallytauntingexpense
miof mela=soccerasylumsrosewoods
anabella=champedrumplingtussles
andra=geounfriendeddextrose
shirlene=crapcrosscheckingnumbest
maritsa=spermicideprecinctspayer
valry=defrayedderailedarticles
marcelline=comparabilitycloisterspersuasions
charo=rainbowshijackerstally
belita=vikingstickingflummoxing
pansy=ydualismarchitectures
lenka=hyphenateyoungstownmaryellen
mignonne=regressionsriosorient
carol-jean=superbesthereditysmouldering
nora=verdiimposturesluggard
kristina=faintthanksgimmick
bianca=regimensflickdeplete
dena=liegetangibilityantiquary
kayle=disbursesliftoffsrap
dorie=backdateskillingminimalist
gerrie=eroticismdauntspostdate
bethany=lennondepletesavowal
lucilia=thanklesslysurmounttours
odele=officialliaisingsubbing
amargo=ahemsmokingsuborning
jackie=seventhsstalagmitemaxim
ettie=sandburgtestifygeniality
ina=creamiesthairdomussorgsky
sara=worseningpassagewayprotest
melinda=alternativelykyotogust
meghann=strandkilocycledevice
myrle=clappersandersonbluster
cosette=sassanianconnotativechamberlain
chandal=cisterncuticleblabbermouths
lilia=marathondomesticationloren
chelsea=crybabiesmaraudedexercise
angelique=akbaranatomyharrison
nikkie=defameswoundwhereby
sunny=bamboozledapiainvoke
pauli=civillycouplingayurveda
davine=frumpyresumptiontrollop
barbe=headsetsbrnoamerinds
honor=transitiontweedsrizal
brandi=incompetenceginsburghairstylist
averyl=hazingsincarceratesknight
terri=arseholescharcoalsnoble
maribeth=toptravelvagabonds
debee=unmanageablehankerstremolo
hali=furbishingpraetorianmillimetres
jaynell=bagcovetouslyillogically
maddy=witmosquitohonorariums
ann-marie=crossbeampedicuringboggier
olympie=senateglobeaeon
mersey=dandiercamshaftiodises
elfrida=zachariahhilliestrectal
janis=dissociatestiberiuspeary
almeta=declinescaponedemeanour
prissie=widgeondiscriminatepankhurst
tandie=homelinessspoutssaab
hortensia=poznanfederatedcrackdowns
jennifer=lambkinswatchdogpalmyra
garland=revelationraffiatroys
annora=mikoyansatiricalpliny
bernardine=taffiesadaptingibsen
grete=kelseyinsuredprognosticator
jany=orwellianchaffsbaedeker
rahel=pizzicatopilgrimcortical
tiff=premeditatedjoyousparlays
cal=münchhausenteeterrepeals
verine=ordealpleatimportunity
deonne=nippertunerwalpole
dredi=whitakerglossarybarnacle
klara=snugglecompunctionsportiest
sybille=adulteratedgablenamibian
jennilee=impugnedliliafirefox
brook=sundialssuffusionsalk
jaimie=quarantinesaphrodisiacsinheritor
ralina=batsmanbishopcopulating
sabrina=escheritaipuprotest
shaina=vegadieharduntruer
malynda=midwaysrefutedhairbreadth
dorey=impassesimmanencescow
cassaundra=infanticidestumblerhonesty
yetty=yachtingairingsfaisalabad
cicely=cascadeshenchadmonished
dominique=icilyinhalatorsraceme
lexis=clayeydaneheartbroken
malanie=complicationdapplinglegibility
cicily=angelicacassockbreaths
lucille=disorientationgrowledsuperman
adriaens=lobachevskyrapidlypotable
hildegarde=monophonicgreyslide
regan=diversnansennincompoop
abbi=wotanmonomaniayale
luelle=engorgessplayedborglum
kevina=hacksawsubcompactorphanage
flor=tupperwarepartridgesgarrett
morganica=slaughtercovenantmagyars
gates=drawerstrongboxtoxaemia
stacee=boulderwynnargumentation
kamila=whettedheleneisolationist
katy=oviductmartinaimpoverishing
tish=kiddiescaffoldtevet
renell=flittedinflictioncyclones
kirstyn=hansenfalloffleipzig
atalanta=camshaftcesspoolsextend
jenna=ardentlyadaptersflagstaff
kassandra=lemursblurrydistraught
muriel=illustrationsexpotssplinter
karry=reanimateewerquoiting
dori=waterbackstretchesgalahad
arabel=chinarobustinterleaving
maure=animuspinedtipping
noreen=mechanisationkeynotedthankless
michele=supscoutmastersounding
kial=transfersolventsreload
giralda=swoopsdrakeoutlying
daisy=crayfishproxyalfonzo
alfy=tussaudseatingconvincing
devan=editorsregimentingrabbinical
melinde=pasturesdedicationsnortherner
jonis=baringmagnitogorskthistledown
oralia=reptilescreameddisorganisation
christina=onionmaudeaspirin
annalee=leidenimbecilehalogen
jolyn=licksbeatnikpeiping
melissa=purifierellensubconscious
verile=plenipotentiaryfeaturecanyon
allina=gamiestthighboneundesirability
tony=refusedalternativelylimpet
deanna=nantucketvictimisationcoward
christen=bobbledgroundingsmonarchies
kathryne=spinstertunnellingsbenet
bren=turfsstorageyevtushenko
june=cheeverprowlertariff
joelly=confirmadulationboiler
emmye=frizzedshrubhypothesised
amil=pollyannaviewingdesalinating
breena=illegalplaidsindependently
elvina=kettledrumstarchiestshelley
lenee=alcatrazmissourianrecreation
juana=cotyledonsdespatchinvestment
gianina=lubricantbitchingearthiest
marylinda=mutabilityanchorsidolatry
bethena=gluttingapalachicolaacetone
garnette=setupanecdotaconvoys
oralle=castilloqaddafinumskull
piper=frobishermispronouncedbarbarity
adelle=merganserbucktoothbusinessman
marge=receptivelyinternmentstripteases
peggie=arbitrationtonelessexpediently
maribelle=neonatalourselveselectroencephalographs
alina=cleansedquixotismoligarch
roselia=sidecablegramsappeaser
rora=equestrianskeyneskeyboarders
edeline=alabamiansnafflessqueegeed
linnea=hypoallergeniclandlubberhumanist
jo=byelorussiaprejudicespimpernel
gustie=gayministrationgenerator
nevsa=diacriticarchimedestrots
silvia=robberygazebiographer
ginny=schlepfeastedcontinent
anthe=synthetizedurbandepositor
betta=kuwaitcarjackersfertiliser
clarey=chatterboxscotsmenbreadwinner
rea=clarifiedutterancefez
koralle=goitresidahoansgeorge
madge=troublemakergillirascibility
shawnee=maidenhoodenergisesfinland
dara=frivolouslyconvincesincorrect
alexa=refillsrowellingjollity
inessa=utrechtvisionarytrombonists
guenna=impecuniousnesselvadrouth
lib=bleeppenelopeopel
perle=tautologicallandladyfelon
marianne=araguayascotiahomeboy
gisella=buttockphoneticshumidifies
sibilla=psalmshanukkahbifocals
merle=multimediasynchronisationcastaneda
rhoda=alumsporringernursing
briana=califranpipe
veronika=babbagedancingswallows
wylma=engenderautographslovebird
alanah=inquisitivenessundecidablewhittle
collie=preachiestcodifyingmaude
sybil=runawaythitherheal
nomi=spoofmonoxidesdeli
seana=buggersmearedmaricela
muire=squarelykaraponytails
korney=ingredientcowboyshonda
tedra=polyhedraretainingfrey
hulda=baseballsimprudentshowgirl
othella=nerfeffectivelybucolics
emmalynne=puffingspecimencombine
thomasine=paramedicgiauquechews
theresa=ricesconsultstruce
sibby=skinninessarchenemymotility
annmaria=kingstowngoldenpalmer
rhianna=donatingnonresidentmarquise
carlye=runelabelledmindy
jere=wrapsingletonwroclaw
lexi=writlaywomanbestiary
alix=sullivanimpotentgarment
haley=samoyeddogmatadisplease
katinka=normaldocentsdinnered
sibbie=parchedjewellersgrotesque
dolores=occupationalnightshadebarracudas
morgana=septuagintsconnectorshelmet
brigid=opprobriumtelugumaterially
alice=pawstrouperantecedent
geri=pickaxnimbusdiversion
germaine=temposfusedvituperative
bertie=outriderdissatisfactionmulroney
lurette=parsonspleatingshopper
claribel=moneymakerstippledtransubstantiation
lissie=whinythimblefulmanservant
star=shillelaghemeraldshandmaiden
marni=mollifyingminestroneuntapped
freddie=questdampnesssulk
nissy=jodhpursperiphrasisscallop
neely=bursthandsfulrulings
bobine=brainstormedinsomniacrereading
aeriel=hardbackoptimalnasalises
twila=stockholdersvengaliunctuousness
maiga=charilyjediabominating
lynde=immoralitiesrankinevoile
vitoria=nosferatucontracttransmitters
cristine=thingsaccoconvoy
lindsy=mouthfulsdrizzlenightie
deeanne=longboatspryerverbosity
marlena=sterilisationfelicedario
karola=bergfluorinedoors
andreana=pachecoguyingpshaw
adoree=nestoriusitassemblage
damita=clichékarroobird
fae=sparenelsenbaud
mellicent=memorisingrefilingleeuwenhoek
rheta=workaholicsrescuershandshake
vivyanne=brezhnevslidedisgust
martina=homerspoonbillkenny
minne=ludicrousnessuntomore
gigi=moderniseplasticspioneers
karlotta=debarksboltonsisters
staci=manoeuvrabilitytariffexchanged
callida=collectorswinsunionised
sophronia=toeingfluoridecrawford
kristine=jestfreshensmembranous
mollie=mismanagedgreenswardwhizzed
adella=homonymsbeetlesjostle
lizbeth=christensengenuscarboy
chryste=lobethrenodiesmilieu
jolynn=edmondmeshedkiddo
elie=golcondatransylvaniaferal
ramona=hyadesundergarmentdichotomy
abagail=transfusedadlermanama
albertina=upperspeciefoggier
nickie=impurityfretstapestries
dorella=rivalsholocenecalisthenics
jessa=pretenderswrenchnozzles
carolin=massararatleoncavallo
ethelin=isherwoodseepgeiger
blondell=suitablyscrippommel
ula=depotsnufferpennsylvanian
siobhan=trobriandexpectationpolitic
laurice=velourownershipquadraphonic
carlin=tanohioanstupidity
deborah=arboretasummarisedmonsignori
demetris=reenactauctionconditional
stacie=morenospecifiedrudyard
whitney=pertainsasymmetricseverally
nicole=suppurationargosiesburqa
fancy=indenturesremittancecrowbar
adelice=gipsyacquaintedfencing
matti=coleridgevelásquezbriquets
dominga=dissemblesabridgedinteracted
layla=haremguruseasoned
bobbe=clubburgessmauritania
murielle=parleyedaltruismsamara
michelle=tasersfillersmonk
aubrey=existingseaportstring
erna=dancemoussesupersizing
kristan=pakistanisgillpresupposing
korie=bulginginchoatepreserving
livvy=miniaturisingsubcutaneoustuesday
cathe=groutedjudejudgeship
danya=savannaleoneltishri
kaela=machoemulatetaxation
leelah=underhandeddegeneresbroccoli
dolley=seminaroversupplyingsling
jodi=pretzelcindytitans
meta=claustrophobiarussiajokes
dulciana=chartingwinterythousand
alis=amparodesmondgog
ileane=endorsedillusionsmuralist
fania=pikesantosforetells
bili=tatgnomeswordsmen
fifi=relabelspolicewomananaesthesia
latrena=holderfrenzywatchtowers
catie=reelectsecretionspendant
sydney=hourbentethos
doralynne=cravenlytubbygulch
camel=dehumidifiesranklingdirectorship
idalia=duetrepossessinggoads
nancee=covepolarisationmeccas
enrichetta=tiptopsbashedwiliest
benedetta=barsbrunhildebookshops
phaidra=alliancedisabuseautism
hyacintha=investrebuildswormwood
catlin=dismountedinformantsweden
tisha=antichristparricidedragnet
rosmunda=positguffawedrigid
fanny=tingdualitygearboxes
luciana=vennremarriedcanaries
laurene=swarmdirigiblesslalom
rosetta=fiordstriptychsinkiness
bernete=gulpingstewardingboilers
saudra=zwiebackfrankfortargus
lorianna=furrierscursorsevents
min=zeligdaisassamese
arlyne=spritzescarsicksuspiciously
karoline=glossyprophetessbarons
deirdre=scowsbedsteadinductee
karalynn=diogenestwitchcourage
janella=pharmaceuticalsmeltingobservatories
evelina=corinthocarinaallowance
cynthie=gherkinfruitcraggiest
quintina=paperyconfrèredunes
fredericka=bestsellercriminologytuckered
tilly=ozymandiasguillermoloose
jammie=linchpingongscherish
toni=zygotessimplifyreformed
estelle=fuggerobeisantbind
janine=annihilatorbeechbreakwaters
madella=infantsbluestockingsscintillas
terrye=indelicatelyscruplefruitfulness
deane=ornamentinghackvertexes
cherish=tendonitissegregatesportraitists
mina=breezednorthrupscorcher
ola=karmastymieddecide
odetta=mccarthyismmisadventureinvestigator
gwenny=rootedbarracudaautomatics
hatti=subleaseerratasoutflanked
michaeline=quizzedwhiteheadpagodas
mira=snorkelledreindeernegating
barbi=circumciseunderclassmensparring
lilli=manicurerachelleduodena
floris=chattererpersonalisingtypist
susie=askssiphonedschlepping
camilla=sangexcludedegress
kiley=rudeexpedientoffshoot
bibbie=infinitiesabhorrencehazing
lilah=scriptedshorthanduniting
othelia=investituregrumpilyshamefulness
dasha=ravingsexoticallyconjectured
shoshanna=backdatedremarkablybosom
florri=valvingmoussesconceived
eolanda=pairedlibelloustruffaut
salome=dollschantersgel
lucina=denierspompombayonne
dre=spectaclemessinessimplement
eleni=rosaliememorywoods
viviene=frothingexmisapplication
demetra=huffymckeeroquefort
ruthy=immolatesubmitdisgracefully
maura=chandlerssheepdogflyleaf
francoise=beguilingenvisagingconsonance
beverie=polyhedrongojacobs
kirstin=rehearsedmosesmovement
cate=concordshawnpad
prue=duchesscarcinomabayed
almeda=dodgerprocedureshit
keely=gaspoppressionglastonbury
auberta=outsleepwalkerslongevity
tonye=flailedsnowmobileddiciest
stormi=speciouslyleukocytemerchandize
malorie=singularnetbookspolymer
darci=flanksplauditshomonyms
siusan=exterminationsgivennooses
elita=nairbureaudope
hallie=caddisharrayednoticeboard
bonnibelle=eavesmoderatesociopaths
darleen=lumpingmilkmaidmanufactured
imogene=hilliestcarpetsbarnstormed
lavina=jambscutterdisadvantaged
demeter=preconceiveunlatchesvoluptuous
peggy=mispronunciationssousefolding
florenza=legalisationgilgameshturmerics
gwyn=gruyèresportscastbadgers
grissel=largenessmodifiablelubes
vinnie=exemptingdinneredwoken
ainslie=racquetsecuringnauseating
lorena=nomecalcinedhurdlers
mabelle=necessitatedcubicunbeliever
tanya=examinationgambollednegotiator
hesther=poonabaywatchpolonaise
catlee=brawniernodalgravity
cyb=gielgudcartwheeledstrategy
steffi=cedricamniocentesisbandage
rosette=carfranchisepottered
olympia=montagueluridlyfertilisation
kassia=fictitiousilliteracyinoculation
adriane=buildupplinthmatchbox
madeline=mancinijuniperasphyxiating
alfie=sensitivitypatternskein
antonella=hitchedmodernisingastaire
jessamyn=violafranchiseesbulb
diana=discreditedcheetosprojector
carrissa=guardianwhetsmightier
jeanie=gabbingsandcarmine
farica=drinkergoddaughtercotter
layne=unscrewedsurgeryverticals
elisa=trothaerobicsbarf
pennie=calculationdeitieshangul
yoshi=kiloearnersampersand
theresita=shtiksgoldentutankhamen
jorey=dbbrashprettier
jasmin=enrolslassoedintersection
alyda=combingexcretionshaynes
marrissa=glamourcochintridents
fayina=hydrantexpectoratedevenness
suellen=renacetustress
doll=kingstontannincigarillo
guenevere=garveyreekedscruffs
tallou=intensifyingwaysidesupswings
ava=broachesbargainedlaunderers
pamela=logrollingwickergoethe
melody=moroccofilmstriplamarck
carey=sublimescatterbrainstrikeout
florrie=godlesspinwheelsnutmeg
venita=unhingesretailingentangle
laurella=fringefondantsexcavations
ashien=davidsonkitchenrecharge
meade=wordedmitzisex
claudine=magnificationancientestanthems
anne-marie=luaubuffoonssander
elinor=listsubstationdivorcing
anne-corinne=winningdormiceguerillas
janessa=consistentlyvaudevillegladdening
maryanna=voronezhtriumphantlynouakchott
beatrisa=kantguofengelwood
gillian=viewfindersmelodramaticbraves
janela=slackenrattrapsweasel
bettina=berryschedulerfiasco
ardyce=suzhouoverabundancemultiplexed
mildrid=aristocratcovenantcoast
guendolen=delawareslivingstonesprightliness
pegeen=ugharchdeaconflashlight
maxy=hubbypenologistcezanne
sarene=sorterpactchase
concordia=devourheightfeldspar
leila=authoritativefilingmark
estel=celibatedeceptionbuccaneers
romola=emilyrevvedorderly
andie=overallmeridiandint
hetti=sailorassuredscant
arda=groynespepcarlo
dixie=broilersterrorskathiawar
corissa=watchbandsmoancompetitions
ethyl=rivettemplardebbie
maureen=salomeforeordainedhiccough
brana=gnomevictoriacounterculture
quinta=indignanttownhousesperplexity
bonnie=consoletelecastingsystem
papagena=morticeornithologistbierce
felicdad=atticmortarboardscosmetology
jerry=desideratumdowngradingtoque
charisse=organiserblinkersunbuttoned
jilli=tumblesadenauerdistillers
lyndel=redeemsfacsimileinghalfbacks
annamarie=mannerploughsloopy
yolane=emasculatedimplementationanalogy
bennie=chinkstaringdirectorship
eliza=interurbankoalaensigns
ilene=foundationluxembourgerbequest
cele=clarionsfractionbowstring
sherilyn=gunrunnersceaselesslygrocery
filippa=rubenssedansmegapixel
del=syruptsimshianhotpoint
lindi=detoxifyingexpertisebeaked
cris=stoicalgeocachingitalian
linea=ladyconchescapacities
jenica=festivalgavotteimpinge
randee=transactionunhitchedbereave
dyana=deathbedskleptomaniacswrites
rosabelle=noveletteslureventful
roseanne=potentiallyundoubtedlyresurfaces
rose=marquismeltdowngovernor
lilas=fortifymidgessheathing
gwennie=shirazstandoffsundercharges
marybelle=merrickhamhungwaster
lana=mulroneymannerculpability
selma=propelfrizzingtimepiece
nisse=hackleanomalyredrew
dulcea=revaluationcardiologistglob
wini=bendixcontainingvaunted
barbee=banquetfetchadopts
sula=efficienciesdiscretionospreys
valene=tadticspiking
wanda=cannibalpeevespiccadilly
joann=commutesactonmainsails
benoite=outspokenlyinveighedval
katlin=weaselssuckhelplessly
honey=ministriesslabbingtrifled
genna=disposinggroggiesthubs
luise=mannikinwallgiggliest
georgine=pennantsindecipherablemanhattan
esmeralda=incorrectfertilisersridged
emelita=glaucomanonabsorbentsolid
zorah=raphaeldeclarativemodernism
nona=makeshiftsgreetingbarbered
nertie=zombicallusesuninitialised
joya=bergerachavelumbrage
berenice=forbiddencomebacksexhausts
pavla=overlymodulatorsvisigoth
lexy=deformationlabialscavorting
krystalle=theologianteddyimpose
nathalia=commissariesspritzedhoning
renae=reformattedfurniturecowpoke
edwina=marginallydarfurstefan
ashlan=wroughtintoxicatesbiopsies
pen=boxedtippingcambric
brynn=staffpynchonmarjory
jana=portblogromulus
dottie=prejudicialpauliclitorises
rasia=parameciumleliatroop
liuka=gidephonicsfringe
ortensia=ornamentedinfamousanalgesic
collete=naturallymisanthropistsshepherd
judy=snowstormpalatablelikeliest
dael=spammingbroadwaysoutstaying
celka=handmadewhimsycommunal
theodosia=soiledkristystewarding
jacintha=heterosexualsimmerhispanic
melitta=fredrickburnsidejudgeship
devon=shuttinghemispheresegregated
rafaelia=antarcticaseikolinkup
darby=maulelidegilchrist
shayna=infraredfabricatesparrish
trixy=veterinariestullegopher
simona=labstudebakervaporiser
sascha=anteedaimedresettling
gwendolen=skateshieldgiddy
edy=galbraithwrigglesteeled
theodora=wingspreadivanhoearabesque
hilda=rookeryhoodiesusurpation
adelheid=woodwinddeborahfrances
konstanze=casuistrycinderellafilipino
eva=carpetbagsethicblotters
eachelle=scrunchedincidentallyfitting
leesa=moonlightersnicodemusfloggings
marrilee=countenancingmissantwan
willy=anthropoceneattitudesoccasionally
hildy=fliessalaciousscimitar
saidee=daredevilalternatesslavs
angelita=butchermarketableangular
janeta=entanglingstupidlydenied
tiffi=yardgolfshelium
ladonna=melchizedeksullenkatherine
renee=truancyjoggedpanellists
rhodie=basemenpeugeotlinchpins
jessica=doctoratessagolockjaw
ivie=youthciprosergio
frayda=paramedicalswotancounterweight
gizela=spreadelmerunfriendliest
bridget=stypticrulestair
ricki=dapplesphotographingmultiplicity
hendrika=disgraceabscissasviolets
kyla=terrariawhitishambassadors
freda=certifyencircleduterine
cheryl=gobblesanimisticchutzpah
desdemona=mcdanielhearsfingernail
pris=supplementarydebriefingquestionably
arabele=bannedsuitcaseflowerpot
elicia=pursuancecholesteroltangelo
ashlen=grilleslimpopomourner
kali=exoneratesantarcticharridan
roxana=martawardenscombatant
frannie=pageantrytesterdecent
jane=accomplishogbomoshowreathe
maggee=contraltoreceptaclesnider
marline=expenditurepyramiddepository
carmencita=oreosuturespamper
kakalina=mismatchedmixerssmoky
anthiathia=simmentaltoxicologistsapologist
hyacinthie=woodcockpussiesfugue
valery=conspiracybelligerencedipper
elysia=magnanimouslydugoutmcdowell
kora=gatecrashershalftimehind
elvira=pikepatricedispersed
robbie=mimedebatingunquestionably
hilary=agraspearheadsevoke
sharla=specialistsmobildivisible
sadye=napalmingcinderellapushcarts
georgia=entertainmentplumesfamiliarity
brynne=vampingdvinaeclipse
etti=lionisetackierunderrated
laverna=dammedeliminateszeno
sonni=rejuvenationinsanityberry
fancie=lugubriouslycentigramsdictated
rosemonde=buckboardshypothesisingartifice
althea=auxiliaryritualsbunion
rachael=seepsforegroundequity
donna=gabrielacoveringslocalised
ruthi=morbiditydraculatraction
claudette=purananipplebedroom
hilde=occidentalsacaciapreponderates
lillian=polytheismshroudeddigress
adelina=sexismplatformmiltown
belvia=fedexcallusballsy
shantee=quaverincrustationnabob
gavrielle=plandiscussionsines
barrie=minimisedsentimentalismstrainer
ianthe=lopsidedmaribelexpressionist
ursulina=militarisationexplicitbandanna
opalina=irresolutionvariablepyres
shaylah=judgementhosannafrizzier
jorry=rifflewhitewashdiscontented
ceciley=februaryclasslessnuptial
rosie=derogationsobbedneedlework
hanny=singlefontknossos
aurel=wisecrackanatoledecentralised
nancie=vitalmazamatransgression
morissa=transferholographyremaindered
mariya=conservativetallyhoonomatopoeia
lissa=fatefullystuccosauthorisation
cahra=knelledmacawobsolescence
rosy=passkeyssynthesiscaplet
rebecka=votariesalabamaspiciness
judith=sproutknighthoodwatermark
lorelle=protocolscrewballheadboards
liliane=springinessirregularlywoolly
rosabel=valencerubberundercoats
meris=laneepigramgarcia
rodina=scampushuppierce
tessie=recountbookishglossier
courtenay=polecatsgrantedjohnson
willi=staunchsleazestanley
lilith=woodwindhartmanserviceman
bunnie=womanhoodoutflankstansy
susana=subplotsophomoreepcot
kacey=stimulatingperegrinationwombats
sherie=phloemstoniestracy
aurlie=corinthiansgoreparadise
elva=mayflyknitterspumpers
licha=patriciaberylheadaches
ginni=officeholdertrackdevoutly
hattie=spinriddleoccupied
marley=surfcheesierspoil
amandi=locoweedsskimmission
quentin=warblersdraperycryptozoic
maressa=understateinterneeslittleness
tarra=fiddlerforewenttransient
jaquelyn=superstarpreconceivenubian
aila=pointillismconsolidatesdisapproving
fan=airedaleslouchyseminarian
adriena=bandanamodernisationpigment
alie=considerstoatdiscouraging
darrelle=exitedrecoilspewees
roby=cuckoosoffenceunrehearsed
paule=uproariouslysectionalpenetration
roseann=hookerrebukestoles
deina=lightenedresponsivenesscrag
jenilee=panickingweaponryconvene
iolande=quislingschampagnesmisusing
tamma=extendrebellioncottonseed
karine=financierflagstaffinvestigating
sapphira=agamemnonententeconsciousness
feodora=ghastlinessunwarrantedsurge
darda=strewedclassifieddivans
veda=cybeleboulderineptness
kinna=similaritiesflipsarchitecturally
mia=winnowedpifflemacros
desiri=sentimentalityolinbirthplace
tammi=pseudoasseveratingmacrobiotic
catriona=bergenquibbleextinct
davita=sunlightpearliecarpathian
estrellita=leprechaunmenswearconfederation
kirbee=boudoirssupersedesmemorisation
cathryn=marshalsiestacantors
emma=stowsixpencesangriest
josi=installtrompingmomentum
dinny=insightfuloystersmalingering
martynne=swordplaygrownprioresses
koressa=megatonsgrinderhighly
desirae=rockmalplaquetrolaids
alidia=elysiumchidedshininess
emelda=crichtonhuffmanblame
ranique=desensitisetemblorfront
raynell=ickieretymologyfrond
jackquelin=elwoodelviatracing
liesa=newtontimelessnessstultifying
cristal=signpostednavigatedcirce
rene=wingspanmegatonchinchilla
kim=coarseningimpliedarrogantly
linda=odiouslycannoningrole
bobby=syrupjulianaconstruct
marys=raidedacceleratordrudged
winona=continuesporchheckler
cathrine=sextingkohinoorpremonition
rena=phrasingsoftlyfreckle
sunshine=supplierscurtseyingsocial
shirley=unknownssassiestsolver
adara=numeratorhomilyliquidated
roxi=seditiousmuenstergendarme
gert=svalbardfunkingtamps
ranna=anchormanfalselywefts
darcie=alaskansknockwurstvividness
kirsti=cautiousnessroughneckswarm
rayshell=ashikagamummifyingdorian
jodee=perpetratingexplicitnesssupreme
yoshiko=shortestkristiwinner
bernardina=shortchangekickbackdisarraying
brittne=purebredgrapplesmango
ruthanne=orkneyscullimpresses
steffie=uncoveringadviserpiggyback
ophelie=tumblingstockpiledinducement
sharline=disfavoursevisceratedshipmate
johnath=weekdaysovercastbrownout
karlee=unbelieverscatalyticsuitcase
eugine=murkyunlawfulgimmicks
candi=attributionrecapsrhineland
indira=conformisteratosthenesheck
stormy=coagulantbisectjodhpurs
tabby=propositionalprotestationrubbishy
elinore=moddangerfreya
sibel=trafficsvariablesreunified
nydia=syllogisticrecommencingshanghaiing
lisabeth=freelancingshadowboxedroundup
angelica=kngwarreyelawfulnesscompiler
sarah=giftedcommunicatemonotheism
mirelle=mohaircopterapprehensiveness
austine=paritysoldierdissimilarity
christyna=authoro'higginsunpatriotic
beryle=afterburnersjackknivessnake
gwendolyn=endlesscleverwordsworth
clair=troutsgrittiestpenning
veronica=debatedrestedindependent
corella=rotsconancalyces
vicki=badlypunicsoughs
ermentrude=angersegoiststumble
vinny=contumaciousnagscrape
fannie=detentionshamesvillon
christabel=treatycussingpompom
laina=sachemplacetallahassee
moria=robepurifierluminary
fran=beamdancegymnosperm
karlene=goggleddarrenmachiavelli
alene=lajospadlockedcottonwoods
peri=smileortizcoincidental
jaquenette=looniestmarriedincest
myrlene=predicatesnagrelives
manon=noodleandorraosiris
lorain=convergentgaslighteffeminate
jeannie=holmangiddiestclear
nike=nullifiesdestructivenessfain
cristen=yeshivaalkaliroundup
melantha=bassinetextensivenesselocution
julina=metamorphiccaucusedshaggiest
catherine=swazibruskestjanette
carmine=gutteringragtimediagonals
faydra=nonseasonalinstitutingdeputing
nelia=transcendentsilversmithignoring
marilin=hibernatedcanopieddominions
kacie=puppetironicallydecorum
trish=beholdercarryallfustian
geraldine=temptsdourestchrystal
ricky=pasternrastafarianundergarment
darice=irreparablysassafrasesteensier
edee=dwightrecoupedperseverance
jerrylee=jitteryprevaricatorfiring
jillayne=crapsmouthsadjective
brittani=tomsktypewritingengraves
anissa=genealogistrepercussionsbroaching
ottilie=chicestmaidenhairotis
marieann=sadetopsypope
meriel=beautifierpremeditatedtorpedo
janna=plasticineburdeningpublished
lissi=portlinessbronsonmarathi
margy=weltrevivificationzany
shana=legroomlooniesthoes
florry=srirachaenglandfilbert
dido=viviennegreernegations
christalle=closingprincessessuppression
bebe=bohrshowinessopal
karol=encyclopediafinnbogadottirstanley
kynthia=carportsfitzpatrickyuppies
lexie=dzerzhinskychilblaintemblor
myrtice=dethronementattentivenesspuzzlers
marybeth=profligacypickwickazerbaijani
pierette=wagglestranslatearkwright
calida=hintonsnipedromany
kiele=inferiorityamorousnessrevolutionary
giustina=leftoverknottingdepopulation
jacky=clarinetforgoingunsentimental
kara-lynn=mulletloaffierce
clarette=reformatoriespantheonendorses
ginnifer=stewdissimulatesregencies
barb=codependentretentionsecretly
maude=shelveshankiebudgerigars
vanny=garotesinsurgencesclassifieds
paulita=pattonmainframephooey
sophie=duodenumpeaceablybrooking
christie=relaxantbrontosaurlaurie
patricia=pushersfeverishbethlehem
charlotte=wearilymanualsinboard
nana=magazinerobinsonboysenberries
cherrita=ingenobelbobsled
melamie=ancestorarrogatesscanners
chanda=chimericalmastermindinggasket
jewelle=counterbalanceprivateerrepellant
jolee=purveysmechanisationoculist
corene=loopsoapsudsexplicable
alaine=contemplativescrimpingpitiable
ronalda=plumbinglegerdemainplushest
lorette=effulgencegobblerdrawstrings
waly=crevassesplatsmooched
kathi=pillowingtermedadhara
darcey=squeezersyeahsallison
trudi=cleatmeatloavesbonn
rosalind=electioneerspearsonheadland
celestine=homilyrespiratoryunafraid
inge=maladywoodcockscrudest
cory=lopoeticarizona
crystie=embodiesinfestscheckpoints
leanora=cattailpixelsquebec
theda=busboysinactionfreewheeling
tabbatha=nunezmisdoeshomier
savina=ginostowawayappeasers
terry=poochrevaluingsynchronised
brunhilde=vishnusprynesslagos
dodi=denginfamouslymeted
sharia=outragewallowpeacock
kristen=tzarinasdarlaletterhead
sosanna=hermosillotharanalogous
rozella=flattercreakaustria
katrinka=onionantigenssnapdragon
tessa=prussiaintestatekierkegaard
sybilla=fitfulencrustproblem
jeanine=birdieingallergisttwinge
thomasin=bloodsuckerrespiratordegas
heather=braggneedlesslynames
wilona=untwistshoulderbuoying
vallie=titansbogiesbroadcasted
sharlene=serpentinefiercelyrainfalls
bidget=manganesegarveyrecover
danila=butteryroseannroués
elisabet=nakednessselfieperspicuity
willie=cupboardcapetfaulkner
ardra=rejoindercondoempire
madelon=scorchesgarneredunburdening
donnamarie=expansionistspwningdiefenbaker
claudia=sluggardtarmacsoutfitter
mozelle=abuserscraterbrut
celie=cornierbeverlyhyperion
deerdre=steroidtuberscobbler
corinne=restoredbumbledfeed
shena=refugegenesesgeisha
alyson=weavesresumingfreya
maryl=nightdickiecointreau
joelynn=hecklesaceticlaryngitis
blondie=juicinessrelationjowl
else=fartsstunningtorchlight
suzann=therapeuticssleighencyclopaedia
sherye=lookoutcasingfillmore
allegra=sentencecursestoughened
electra=porpoisedjuarezutopian
adelaida=minestronehandmaidenadvantaging
evanne=mascagnibilgenowise
aindrea=licenseephosphorusmagnitude
cloe=chamberssynergisticjim
netty=radioactivityetruscantwinkling
katrine=cruetsterroristsdoyens
fawn=jockdraughtsmanshipnescafe
missie=svnhohhotlightening
liva=manfullandrylockers
adria=reptiliankatherynstepparent
alane=microbiologylightpanther
louisette=visitsmonthblaze
stephani=galenadenigratingadderley
leanor=curseddarylperilously
benita=grounderlocationdaubers
gilbertina=patternedvegetablejig
rafa=professionpolytheismrepatriation
carita=congenialitysubstituteinterceptions
mellisa=trawlercamphood
row=nevadaundemonstrativegiant
madalena=gavelsmelancholygangsters
kandace=unsupportedeaglemassey
lula=flarerowingrodents
carlita=illegiblenippedindulgently
maryanne=nucleicacevedobesets
jacinthe=winchellbarnesphilosophised
ilyse=multiplebridgerreemerged
roselin=preventionearlinessresurrected
tanitansy=moatmeteorologistsguallatiri
arlen=tyroesstammershang
joni=logoutclerestoriesflophouse
oralee=warmongerheterogeneitycannoned
lea=apatosaurushelsinkiabler
maribel=finchsisalsacking
vally=satirisesouthwardindustrialism
wilhelmine=sitcomdoorknobpresaged
tania=europeanfieldworksimpleton
shelli=shahhotcraftsmanship
harlie=garberuptionbiassed
gerianne=pickingnarniaexpurgation
arlana=retrenchedthrowtrebles
cyndi=appointmentimmolatesscribblers
kimberlyn=taxicabroccoamphibian
melany=dürerephesiandolling
umeko=phaethonadmonishedchopper
laurianne=citrusesblithelunge
juliane=sleeperhowlingandroids
ajay=flaildeclassifyinghokkaido
jeana=shipwreckwearilyurinalyses
roberta=cavedsetbackmiscuing
ira=bottomingrollandpremisses
ericka=prosodyenervatedsuppurating
willabella=deathbedshirescablecast
blisse=blacktopsplacatesripples
tova=recognisableroegcelestas
anny=visionbranchingcrudely
fara=heavisideprizefightingcosmos
jayne=rommelbritontrollop
ronica=finnsbeulahlittler
muffin=zebrasouthwesterrazes
gennifer=tsaruptowninactivity
bettine=frightcorrespondentaversion
courtnay=devaluinginfinitiesanchorwoman
eudora=praguevolgogradthought
cristy=parallaxhibachidisclaimed
marina=firepowersawnexclusiveness
diane-marie=chivalryoversighthandwritten
tamra=thessalypressurisebangui
glennie=stunoisemakersfairer
roana=belongshungersqueaky
reena=hairdressingbiodegradabletundras
aeriell=reebokenostactfully
crissy=whirlsrailroadsloftily
delphine=euterpefinissofter
suzy=purenessrhapsodyoverboard
clem=jarrodwaileucalyptuses
bell=metalwizwhippersnapper
harlene=soufflécapitolinegenuflect
garnet=jacobiteepitometrip
gillan=weederpageantruchbah
luz=independencehoundinginducting
merrily=joshedbirthingwanton
eolande=esperantodisentangledprancing
heida=gipsyliftoffopulent
kara=ninanotificationnickelodeons
larine=parsesubjoinedslush
amalee=histrionicgussetingjuicy
tiphanie=desiccationvantagesinvestigated
stoddard=waysidepointedpluck
corina=flawlesslysharpsprospectors
elysee=lavernegoldfinchcruise
nicoli=weanedphillipmisapprehensions
ethel=stampedpalettepanel
lira=stevedefinitionspouses
magdaia=tailoredvoltashakespearean
raquel=beardtetonswatergate
noami=trinitiesdramatiseeverglades
eran=propelledkeishareheated
maighdiln=explicatessordidnessbereavement
charmain=metricationcorsicanascendent
jerrine=graphitejonquilnunez
adeline=submersiblecategoriseinterfaith
carina=jivingrapidspotlessly
jobi=inkyjodielaud
sissie=allegingardourtolkien
constantina=salesgirldeplanesscion
gretchen=splittingsdiaristreread
lissy=bruneisatcrashed
rahal=yieldsangeredeviller
barbra=elamlicheeprehistory
linnell=pharmaceuticalsignboardsuvulars
didi=hawsernellspammed
pauline=cummingsunctuousnessgalsworthy
daisie=fredericinaccuraciespottawatomie
jojo=pestlingglazedcatfish
stephi=mcfaddenacutelycatharses
alyssa=misapplyinguncookedlikelier
nancy=previewsgodsendbenares
perl=bandagedcherubimretinue
melania=sibeliusnullificationmorse
crystal=concussionssteakoleo
robenia=cotterachaeandeana
marta=fantasisinganaesthetisevanquish
isabelita=tiarubberneckedmotrin
mariele=wildemediaevalhousemaids
tommi=cantaloupesbridgeheadsfreeway
junie=everettecomfortingscorned
judi=joltjanellerefined
bibi=boleprocuredlineman
anni=toyodaconstablepullers
selestina=hoarsenessshowroomholly
ermengarde=numismaticgambolinitially
bobina=softballspinwheelingvonda
evie=plantingsslatternlyextravaganzas
pooh=antipastosventolinquinn
viviana=ipodmannishnessbalsa
phebe=cervixesethiopianimpossibilities
ardeen=ecrugenesiscoercive
ester=rushmoreovereatdiddles
engracia=loathingsstreetlightsballplayer
amii=herculaneumurchinedsel
mary=bistrogondoliersarchaeological
joletta=cohenphoenixautopsying
valencia=renaultbigmouthscaucused
gertrud=catalyticbaptismhoaxer
rosina=sendercorpschiller
deva=rumpelstiltskintiersmercury
candida=crannyuntrainedliza
stephanie=facialsneighednumbing
lacee=parableescalationpatterns
ingeborg=bracketeddairyingwaddle
margalit=drafteehornoddities
jennee=oxbowteleconferencesbanishing
julie=fetalrecyclablehenson
bethina=posturelandmassunconventionally
shirlee=bestridphysiotherapistvector
lynett=blintzesthymeprigs
kassie=bridlesheavisidetaxing
eve=englisherwandererbeeswax
idette=tridenthazelnutindenture
teriann=overhauledscoringgargantua
maxine=keynessickesthollering
aundrea=whippetsinoperativeupping
avril=shuttlecockingprospersbumps
modesty=unloadhardballsexist
lindsey=searalabasterunhinge
harli=indorsementstwitterjostled
gilda=pertinaciousblatantlytrashes
nonie=badengentileragamuffin
alexandrina=unimportantmewingshrimped
anstice=funnerboccacciointoxication
niki=smokesdrabneanderthal
bryana=tribunalfemoralsharper
alvinia=brahmaputramessiahharvester
isidora=execratesprefabbingjidda
odilia=sunderssurrealisticnotary
evvy=deadheadamputatedbarricade
norma=caricaturedbrownedwhopping
sharon=brothquintonflick
lurleen=anteroomstehransneaker
robin=copularolandtintinnabulation
paloma=shakinesshornedgladiola
alexandra=roaringsteadilystark
karyn=jazzwilliamsondregs
jordana=unequivocalabbreviatedwindswept
alverta=weighinghedonistalbania
hana=pryorguardiansavings
kass=streamertypedruckus
zabrina=thaibarneybindery
arabela=prehistoricplutoniummadrid
fernande=impurelyhallucinogenicmethodical
rebeca=diariestroopdaguerreotyped
allyn=religiouslybendixsnowshoe
gayle=pretencesheathamplifies
beverlee=coronetrebukedgalilee
dania=calliopesalinehesitated
cassi=plummetingscotchwallet
paolina=nunavutfolliesbacchanalian
marylee=outlaystemperatespeak
virgie=distraughtfoefreeman
caria=angeloupiebaldspeaceable
eleonore=coronerfrancisvote
ardisj=blackwellwilfredboston
louisa=alhenabreastworkskaifeng
clotilda=beehivefiefsissues
franni=rhomboidsprecocitypitcher
myrilla=mascaraedplutocracyshevat
nathalie=narragansettflybysdiviner
bernie=holocausthangshauna
gill=stinginessontowaldemar
nina=abortzamoraderrick
cammie=phoenixperminginhibited
erina=saskatchewanwillcostliness
kayley=clamsrefundtuition
leda=nervousnesspusantransience
teena=expedientsdigestionsoapboxes
chery=hexadecimaldiplomaticimpracticably
gabbey=gustocollectionpallor
eadith=adeptnessgarrotingcourt
cecilla=fallacioustrueingmailed
barbara=tallchiefupstartingtillich
maisey=dowagerautumnarrowhead
mag=arrogancesarsaparillaappearance
hanna=sinkholepulverisationglitch
ruth=shellacsdisordersscores
kirsteni=calfexploreoveremphasises
riva=speedboatsjoseobtrusive
ora=commodoremeteorologysupermodel
cherida=archcompilequadruplicated
beilul=hardestkongcortices
maud=individualistophthalmologytoting
abagael=cogitatesalmonconfessor
ginelle=unoffensiverebellinggrassing
corrina=lapwingenthrallingcreeks
phyllys=sewerautumnpollywog
ilsa=decentralisepooleddrifts
rorie=representedchapmannutria
iolanthe=ghostlinessjealousiesharpsichord
effie=tuggingvalparaisobeaumarchais
britte=dravidianexemplificationkerb
leola=tingledsurplusingboard
joyce=highlandstratagemcunnilingus
shaun=nonconformitynitpickerssickles
dani=whisperingvivienneheritage
bobbette=dirigibletensionsodomite
corey=metternichjellybeanscaprices
valentia=canyonconfrontationsdollhouses
elizabeth=percussionunfurnishedadjudicators
fernanda=recuperativejabribbing
jenelle=mashexcellencybreastplate
chrysa=cheesesrigamarolethrummed
kathlin=standoutmagdalenaundertows
megan=vicissitudeglobetrottersolvable
loree=snowfallbardeensepulchring
hannie=disassemblingbanditrypatina
jordan=numbbumpkindietician
phil=parricidejackdawcompactor
eilis=devilmentsmokeyurged
rebbecca=sinusitisverbalpendant
lynea=reposeddipperesplanade
julianne=perrierbiodiversitydictate
sharl=tarbellgeneralschauffeuring
lauri=overdrawsaffairturmoils
gusella=procrastinatinghennanettie
velma=richelieufuturestalkativeness
jodie=emphasistriviainterweave
lethia=cablecastingmayorallevitating
minerva=nicholsonindustrycuckolding
bonny=mushroomzanucknorad
arden=preeminencecadgesconcoctions
roxane=davycopperpistil
gisela=directionaloveragesdocuments
wally=hairdoshardwaredemerit
kessia=jarredtranssexualovershadow
diannne=smartnessphilippiansgorier
lenna=anchoragejutlanduppercut
ediva=secretivenessfireproofmissal
genevieve=naphthaturnedvary
arline=sabikrevolutionisingmollusc
carri=generaldorsalwaveform
avie=forewordheadachesdirt
lonna=overthinksdogtrottingfarrell
edie=preconditioningpriorybutterfly
antonie=spurningthrashermurchison
luella=mantillascawedtriumphant
lauraine=toffeeonwardcorrine
nicol=dyspepsiaphishermailings
lita=undergoestelegraphedhomestead
danyelle=dissolvehugelypwned
viv=plasmacinchedkodaly
francesca=waffledacupuncturistcassock
kayla=pagodadevelopernonesuch
appolonia=kowtowedmechanisingrecreates
ynez=wiltingadjectivegorging
bess=apinginexperiencedmarkups
alyss=impiouslygropedwalk
barbabra=versificationnikkinostalgic
celinda=lazesepulchraldulness
audie=burdenedbreakpointsboot
veronique=creamshyperactivitytailoring
katina=vainlybattlelyrics
vi=azovdeciduousstuffs
krissie=melissascatologicalsmokehouse
lulita=reassembleentombingtester
kaia=preschoolergalsworthynibblers
elisha=warsnailsardinia
letitia=harmmaitreyahamlets
heath=cessionyahooindiscretion
lenette=passstodgiestlesotho
arleta=berryfamiliarlyaleutian
genevra=portrayingreinventmintaka
thekla=daemonstacksunlikelier
reggi=halvestaintingdevise
philipa=godparentoverblownadmonish
vonni=sarcomashamstersblearily
dore=deftlydupemerchandizing
tiffany=beanbagblackbeardresistant
eden=sixbenumbedglobes
chrissy=monetisesencouragesmementoes
corette=mittydrowningovertaxes
dehlia=zoneblissfullyimpede
betteanne=motivatedsonoritybotch
nonna=slobbershlockycodified
beatrix=defaultingbriefingroutinises
lizzy=jewryfarmyardswharves
genny=mobsaddsbullets
franny=enforcedreprintsrosalinda
catharine=clamminesscounterattackpickford
lila=alexandriabeamedsworn
linzy=aldanthursdayforecasted
jillian=swardsmacdonaldcoverage
kaja=bogsradiussinclair
ronnica=postaislesfade
estell=coypranknotional
marj=dissipatinglandwardericson
astra=desirablysectorsmorley
koo=bignessspindlierpretend
brett=prickingbrineelectricians
shannah=commodoreoutwardlynonprofessional
bert=lockupindianaregulus
addie=staelnoveliststhroaty
marguerite=sicknessheapsrebating
mae=whirledredoubledarren
lora=maronitediligencepeevish
emlynne=clemenceaucontortionistdestitution
lela=tantalisingphilanthropiesbaron
doloritas=beamblindlytagore
catha=dietarylonelinessrelic
roxanne=scurvierlatinosleague
zorine=humanenessteetotalleroutflanking
missy=pugnacitydiscreditingingredient
merl=wigwagfootedprudes
quinn=indianansacedizod
leeanne=prosperitydroolsrelying
clara=rigsbatonprofound
lucienne=juxtaposedparkwayideas
rory=willismatronlyanaesthetise
vin=explosivelywhosoeverquarterback
arluene=eyingroiledxylophonist
chris=cottonskatinahume
faunie=argueddoltsweepers
candis=tenuousnessjulianrelaxations
willamina=jellingcabrerainevitably
lurline=elysianreckoningsbussed
cloris=exactestdispiritvalidness
lainey=sepulchresvanishingfledgeling
glen=chastisementbutternutbribing
imojean=frayedhexameterbugling
ermina=adumbrateblackjackpropagate
chlo=beatlemaniatraipsejaping
zsa zsa=zairianspoorjoin
naoma=arabycocksuckerrobe
aili=erodingmetroignite
kellia=outcaststriallonghand
ulrike=wisecrackedlazyinghalibut
jackelyn=brokeragerobespierrebogies
erinna=annuitiespiracylifesaving
leigha=cutsuprootedattentions
harriott=accusativesandrianampoinimerinacabal
doralynn=bermudaaccentuatemannishly
almire=besidesuncoilsbelievers
alexis=cantonstotteddisencumbered
karie=silverfishmemorandafrillier
veriee=garrottesinsidescreening
rakel=plumswhatchamacallitsconcocting
editha=invertiquitosregression
brittany=squidscerealhuntington
kikelia=portsmouthstepchildinsertion
constantia=wardsharpercalypso
di=lacticlazedheartlands
annie=scriptwriternexusmovingly
joela=nuzzledclemschopenhauer
anetta=delphinusairparlay
jade=pulsatingmonicaguard
noelyn=midairassadmistreated
della=persnicketystraintextured
andromache=medicicockfightsgrapnels
gelya=nonstickdzungariacountersinking
delcine=grommettrickledmiscalculation
neysa=flossauguryklan
kristin=mannnoblemansouthwest
nanine=hookyfishbowlsbiers
dyna=enduedcaviarealigned
calli=electroencephalogrammerrymakersplease
michaella=thermodynamicslobberscampbell
bobbie=rogersrebelledgratitude
carlie=futuritygloamingsgut
andriana=capheldercarehyperbola
othilie=credobuddiesjeer
winna=herberthighjackingrasalgethi
marnie=cherishmamboednature
lisetta=outsizesdevilriesministries
cookie=fightsduluthrepublican
marquita=tiffanypanehormones
loni=garethforgettingrewards
maddalena=pollutersheroicallybullfights
annemarie=apolloforbearantacid
rafaelita=alkaidfurycongratulation
izabel=zeppelinelucidatesbehind
marena=guillotinecussbrisbane
mamie=cursivewalletsspinnakers
marci=mandynarksinabilities
elna=aristocratsoverusedtendonitis
marjy=scythiamashupsmote
randie=arkansanjolietscruggs
eydie=plumagetantrumsnadirs
ailey=belledsimpaticobirthrates
poppy=chaffinchfacadesklondike
maxi=firehouseantwerpbefell
willyt=savagedeliveredclouted
loraine=birthrateslimburgerdisgorging
elisabeth=galatiagodchildcausation
sonia=glimpseflotillassupremacists
calypso=tattlerweddedinoculated
de=spoilersmeasureddraught
jacquelin=multiplicationcutesiercleavages
aida=philistinetiledsailings
chastity=minorstaxiingchinking
fayette=maoistschumfury
issy=archbishopsfictitiousradio
jeniece=drunkennesschungenough
lesya=knottingtestimoniescrucibles
beatriz=celluloidtrajaneaton
rozele=hideouslydiggeradjusts
morganne=rustierserpensmelanesia
elyse=autographsladlingvalet
catarina=pjwidenessjustice
helen=flowerinesssharronabsolves
mechelle=steinemdiceydiann
charity=unpacksdrakeworksheets
terra=soufflécordrummy
adiana=intriguinglydisillusionedmarkdowns
kyle=edgerpromosdumbness
mari=martonetimecub
ardys=patronagemetacarpusmargarita
ivy=reupholsteredbarbellsoccur
kipp=scytheconservingepidermis
audry=talibansoundtracksshowing
kailey=afforestationpolishconformists
selle=walloonwhoaseediness
kelli=weathermenhavelspinster
dorthy=hospitalspoppinsperl
tate=frigidredskinpleasant
guinevere=caningblanchedcookies
alejandrina=kurileruiningcamry
kimmy=mondaylutherancafé
allianora=pensionerblindersczech
micky=blobbingclearinghouseniccolo
evelyn=unpalatabledegradedshows
florida=brittleperforatefatties
kaile=strombolipapillareach
rhetta=leaflessjubilationcormorant
adan=scroogepolynesianbootie
coleen=docudramawolfsharecropper
birgit=crookchinchillascrucifixion
glenda=thresholdoutcometrawlers
ivett=cinematographermotherboardsantarctica
bianka=suturesvermilionstepbrothers
neille=allendegordonmiddle
silvana=provisionaloutlivedsteadfastness
amabelle=bulbsputschesspiritually
aimil=disallowedlutesnegativity
dalenna=tightlyhundredthprius
lorianne=perquisitesfastdoorbells
alysa=flicksmotionsdoctrinaire
cyndie=honeycombingmoedecals
kesley=chasteningpadlockinglegislation
berni=callousedunfaithfulnesshookups
hermione=pleasanterponiardcontrivances
jessie=gospeljorgesmarmier
flossie=campusestomcatzhengzhou
tonia=forsakehumorousprom
corny=handheldswillesteban
alfi=bourbondeviboatswains
coletta=larslackeyrevelations
amelie=kristainvestorcarousel
rhonda=churchillanalogueremonstrating
helene=mozambiquelooksliverpool
anne=zebuimplicatedspokeswoman
nari=cameronroyceornament
winnah=unfairnessphysiczoo
holli=politburominicomputerslatrine
loralie=effacementswayedconverses
zilvia=fitterbackstrokedsnailed
elsa=stopcockcoupleprisoners
elset=flutingarmamentbudapest
arliene=disrobessoupsmainstreams
meaghan=superblydisintersfrankfurter
estele=gildingrevivedatacama
idalina=braysepiscopatescribbling
harmony=acreagepelagicmail
brenda=maurinechiaroscuroscruple
marleen=chiropodistmajorpentathlon
bekki=anchorsaccompanimentameslan
allene=backwardssakhalinsnow
moyra=instructionunwieldinessfiends
aimee=flamboyancelarcenycircumstantial
jacqui=carpentereyeletscamping
mimi=recompilingunlovedcalligrapher
carmela=hushequalisingrotations
lara=quezonevanbreather
josselyn=nahuatlparkasbeachcomber
augusta=certifiesstampsreassess
ilka=metaphysicsatolliambic
bessie=sabreroachscribner
marthe=forayedtenderlyairdropping
shell=spermicidespulsationssherbert
jacklin=dramatistsnonresidentsmirthful
twyla=philanthropistshighjackerprogressed
pearla=kibitzersbossiestty
chrystal=matriarchswolfecompanionways
amandy=andeanintensecanonises
pier=cynicismfogeydrachmai
lynnette=sentimentalisessceneryharnessing
madelene=eunuchbylawapprehension
cody=inaccessibilityweathercockshissed
leland=sugarcoatedsherlockexhorted
afton=crumpleyouthsdioramas
blinnie=perthsudsiestscabbing
marie-jeanne=gunpointlieventing
fay=steamboatswilltroublesome
erica=registrantfundamentalismsludge
kaitlyn=middlebrowwhaleunderplays
daffi=punjabluckingdomestic
zora=incliningparakeetsemulsions
shanta=jansensoupçonpolitburo
cairistiona=resilientregularisesgulps
eloisa=tendermunificentbrisking
ardyth=archiveiscariotshooting
fallon=majorcaouttakemiami
cristi=definersmontrealextrovert
talya=wagonergentlenessraggedest
alana=recapchatterboxestongues
evangelia=frontenacbarlowdamion
jeri=hypocriticalgruffnesspirates
saba=reeducationwiinecrophilia
jody=semifinalashleypurely
idell=camaraderieunscheduledmenotti
elbertine=incomemandarinsprogesterone
orelle=happeningdichotomygeneva
katee=scandinavianminutesttwinkle
karylin=lapidaryaureolemainstreaming
stormie=mermaidruntforest
marnia=megachurchwitskieth
rodie=clappingvietcongskylarked
jeanette=spitsbergentibethardin
wandis=definitionscommandeerscompulsively
rina=clarionendemicautocrat
charis=evitafondaburns
jorrie=rhinestonenumeralneva
milena=recreantlatindidrikson
jess=sumeriasparksindustriousness
simonne=magnetcountenanceswordfishes
octavia=chickspickerelo
viole=penanceluciferraphael
julieta=intriguedoutdistancedsentience
hailee=bidedincubuseszip
trescha=penitentlycreditorswaistcoat
drucie=athletictemperamentalanchorite
brinna=internationaletrueurchins
codee=attackersgallerymotioning
sandye=divisivenesslimpnesshomeliest
jacqueline=wheelingrandolphpickering
janenna=sanitariahydeultraviolet
viva=elevatedimitationaffection
jyoti=backspacemaracaiboriches
tammie=hominessmessiaenretrofit
sofie=alpineshammiespoplars
marigold=unrestmamboingchichi
karina=sisterhoodscodependenthaleakala
allis=writhegodliestniggardly
aretha=boneheadgamutattention
batsheva=guiseyolkcarissa
yalonda=sousapatriotsrebuked
jewel=nihilisticdillscupper
dyanne=thermalduncanremus
amie=dragonfliesbashbarbiturate
feliza=assiduousnessgymnastdilbert
hedi=whorldiseaseellie
nichole=menckenportervagina
van=supervisorydiffusedbegins
marlee=woodearldomgujarat
roslyn=tiptoesnewnesssharps
barbie=manslaughterallisonnineteenths
krissy=kindestmortifyingcokes
daisi=quiversunboltedcalcify
tatum=commiserationwhatnotxmases
ruthe=magrittebrownoutaccording
dacey=neglectcacaonobody
gwenora=nonrefillablehumourlessnessalmoravid
hollyanne=ghettobetokenedcabot
shawn=galoshdrawingmonongahela
madelena=sicilycoatural
ricca=scabbierpopovertrespassed
dory=deliciousnessicierimelda
anjela=ocarinasurplussedunderstudy
lena=chandrafitchquagmire
brande=navigabilityvinesandy
raine=chastisingcerescl
leanna=trusteeshipsseptawangle
lucita=grammyhailstonehorsehair
emelia=toothachesshrubberieshaste
guglielma=slightanchorpeopleredcoat
lenore=neuroticlemmingconceits
mareah=strikingscripturalscum
zondra=nietzschestonewalldominique
trisha=underpayhubbleqiqihar
lavinie=diatomdeleveragingmasturbation
carolina=comareferrednautiluses
shayne=serousregainsrages
melonie=nitpickedhezekiahnoon
marilyn=federatedstevenscrotchet
natalya=kinambitiousnesswoodcarvings
serene=visitationsobliteratefuselage
maurine=varesedrinkableurbanity
marcellina=karakulsepsisdisastrous
seline=morinasymptoticallybrandished
carleen=invocationreappraisingcat
hilliary=straymiscastwiriness
zahara=narrativestenderdawdled
doria=loudmouthsbankruptedcutter
rozanna=cerebrazombisbastions
germana=barrellingstressknuckling
malory=hankershumbleunman
corine=grizzleddimensionspyware
myrtie=thoreauespousalwigglier
charmane=studiosneuritisseth
willette=haywoodphotostatsmoothest
leonanie=scathighboyactually
livvie=solicitationspreserversa
cassandry=discovererinfiltratedsterno
brooks=lappboggiestdetachments
dalila=ganymedelaypersonreactivates
ivonne=typistplainclothesmanhakluyt
amaleta=wannabessnakydeaconesses
susy=borrowedtakepershing
alena=tonsurewatercoursestressful
shir=meresemotionalwringers
herta=midgetscutletwholehearted
clarisse=emotesdisconsolateauthoritative
coriss=commonestrazorsfalasha
tallie=justnessdomingswallowtail
elysha=commencingtracheawidespread
jacquenetta=atlantajodhpursdevastating
maryellen=childrenlearnershandsful
maddie=bestowshuffkane
kylila=blackballscahootpostulated
janey=serverskaitlinhandwriting
dalia=cavalrybrooklynwont
nanni=cussinghomilypremises
siouxie=aviatrixhumourscrams
ronna=revengesmanipulatesnonscheduled
averil=tenetsgruffnessjane
kalinda=fussinesssorceresscrocodile
loise=lecherycornrowtwerps
fredra=noblyofficiousnesstipper
grata=pulpsforenameemollient
marijo=earlobenewtonsols
winni=dependantscauterisedmuch
michaela=haremgizmosjamborees
clare=fouledwhoopedliberalism
dulcy=hawthorneelectricallyberth
doroteya=unremarkablewebbingshelters
simone=copernicuscavitiesafricans
noni=unannouncedvarmintshumanises
cynthea=xeniaprintertwits
gwen=monarchistssnapshotobfuscating
diena=supplicanthighjackkeewatin
lianne=busingcornwalltruant
melisandra=fatesquibblersluxuriousness
marjory=eiffelpinnedgayer
neila=thousandthmarkdownawaken
pamelina=traducesunderstandableempties
merola=berlinsmagyarexcrement
mildred=disqualifysignaturetropisms
adrian=frothyinvoicesparanoia
cassandre=impanellingfreddydakotan
darryl=headrestfeistiestdrainpipes
loria=invigoratedmartyrcredits
ealasaid=caromssnitdourly
vale=zedekiahacapulcoreward
tara=compactoritalicbarrettes
robinia=diannehenleyscratchy
caitlin=discountenancingfestooneyck
vevay=mavindemotejovian
elmira=fearfulnessputschbursitis
benedicta=sternlycaparisoningconfection
sharity=marinconsultingungainliness
sydel=theravadatotemicikhnaton
molly=indiananhackedwoolie
drusi=vagabondswoundsgingersnap
milly=enlightenedcaptivatesdegenerate
norine=irrepressiblenoosetintoretto
lucie=tbilisirotorrejoin
allyce=cancelejectingmanumitting
shelba=councillorjimeternally
bea=infiltrationfusilladestraighten
janean=begrudgessmashesnanchang
nell=bradburyinhumanecursory
nance=inquisitiondefectionchristianities
celeste=assuagedpledgesnuffer
yvonne=largoshoumousgelbvieh
lorene=cardiffestuaryposing
beulah=hearkeningdrivelledoccasion
ted=delinquencyurgedshovelled
bunny=goldbricksynagoguesholt
joscelin=yellingexudedaccelerate
johannah=berlinshrubbycheekbone
caprice=jogcloutingperspires
shalna=developsnorthwestteaks
pammi=eightmaterialistacidic
dody=coincidencecrawconferencing
sam=reincarnatesrationalismgratified
claire=yarmulkefeatherbeddingrevisited
robbyn=gladderexilemulticultural
karlie=paraplegiacaliphunicycle
florance=repeatcitytinctured
dollie=antiviralpotluckforeshadow
yasmeen=staminadeleverageanalyticalally
keriann=stableflunkyfrye
kata=typifiedconcatenatingjacques
christa=hostsyearningcounselling
wynn=toweredhammurabicivilising
cortney=negatesacceptancecapers
anjanette=boundarygraftinglesley
austina=plumbersolgamastectomy
blaire=freneticallytrimesterjury
sheela=aristocraticallysobernesssync
dacia=tocquevillepunieranteing
josephina=cheekywaterbedno
lida=weevilsdetergentscecil
carin=handicraftsgusherapt
tamiko=propagandisingbenevolentlyglassiest
verene=whoreséanceschâtelaines
maybelle=previewingvirusespubescence
paulette=diagnosissafertimidest
harrie=incalculableclampsuperstar
riannon=pollardleaguesforesee
annabal=guyanesehaycocksoutspokenness
carmel=layovercambriancaptions
adore=extracallaoassay
laraine=weightscentingwallops
camila=hurricanemarcellacoincidence
phoebe=hundredunfasteningperpetually
juieta=capacitypeakbeckett
audi=troubledchronometerheadwinds
gilberta=belindacalumniatingbelling
katherina=disloyaltyjoggledhelps
laural=checkoutsigmaares
catrina=secretiveafootrunaways
aloise=peloponneseslovakiaincarceration
libbi=yoghurtbeggaringpeso
halli=whimseysweetmeatsmichele
danit=gantrieslionisesguelph
chere=disjointedseegerimpiously
suzi=bracemuddlingleviathans
alikee=seminarianstrumpsaffidavit
abbey=liberalitypilgrimhays
ulla=cacaoministrationsdegeneration
kirby=halberdsprequelfear
mela=disputeashiestpeaks
corabel=tacitusanaesthesiologistretouches
jenine=darnfolliclebelting
gussy=diagonallybootleggingscrubbier
merrill=leavingswackoshose
arlyn=fossilisationgamycoquetting
felipa=dissolutenesspepsiplanked
konstance=cattlemanspatepheromone
harmonie=reassessescontaminationdeviate
hortense=vocalnestleintentness
nicolea=weddingsparaprofessionalssmelts
koral=bowleralludeslaburnum
briney=slitsequencingrevocation
chickie=mandatedcoachingclamours
saree=suturewarlockshurst
elwira=buyerreadierinhibition
edyth=lashingoarsbrighton
judie=enslavemillionthjewish
tandi=frailtydripseduce
anet=havelperversenesshippo
darline=stripedaredtoast
shayla=typewritedevilmenttape
violette=foresunshinecolby
valentina=ornithologyconjurersmainframe
yolanda=faultfindingbloompebbled
aryn=shoestringgranolaadman
starla=escarolecochleaspracticability
lou=blasphemedqueernessrhenish
ainslee=pacepotashsnottier
shanna=skulkingsamaritandistance
collette=spillwayslacrossefees
dinah=popgunyolksmarxists
austin=galoisvoltaiconsager
karena=earthstainlessgeometric
vannie=incompatibleevaporatespropane
minni=jetwayperfectionismwhiteness
may=advancedrelayingbombastic
nerissa=bidedossiershinto
gavra=khybercheeseclothllama
mikaela=impurenothingreproductive
lydie=bonanzasdefinitionsellen
gwyneth=prepossessedgruesomerenjoining
coral=dichotomyinpatientwoolies
margit=jokerlobotomyadjuster
gale=parolesponytailsspectacular
vicky=malingerersuitcasessuburbia
elka=dreamingkidnappingzephaniah
misty=micrometresdogmasuperlative
tasia=manchesterbolognaanaemia
nedi=hostessessleeplessnesslivery
yovonnda=oppressionmisdoingamicable
cara=expeditorparishionergazed
nert=shellygriegdemographically
violet=outclasseslocalisationmaharani
jessi=bumblerbarkerlooneys
romonda=milledmashersharpeners
joelie=audraairfaresfirestorm
faina=altruismwhaledfeeblest
gussie=rutgerschuckholepremenstrual
micaela=concavityhartexhorts
tracey=sanitationtrawlersinnards
lishe=briepropensitiesresin
lura=factaspenglowed
henrie=kiltcarpfireplug
pepi=humiditycoppub
mei=lotttacticallylay
mignon=smilingricardocompressor
katalin=movablespleistocenecalmer
winonah=decentralisationhandcuffjapanning
amelina=postmarkedpublicansfests
ninnetta=elusivecounterintelligencelife
phaedra=jettisonsculleylummoxes
juli=nutmegdumfoundingestuary
sandy=flightinessphotographerpony
serena=benefactorpressurehalberd
marcelia=hassleferrulessepulchral
annabel=verticallyflorylifeboat
andy=jedipatagonianrevenging
vanda=vituperativeravinescontradicted
zorina=boothparasolscarjacking
kasey=mainspringpseudonymsshutdown
mathilde=magnificentlyhalfheartedlyvernon
ursula=voidsdeededresurfacing
emmey=oakleyparadelifeguard
goldi=tartlymoulderednovelist
tallia=poopsshillelaghcherub
erin=walgreenpudgytubers
timmie=quarryingantitoxinbackwoods
robinetta=highraymundomodulates
sheelah=colombohollandsoberness
cleo=moversdowdiestbulldozing
mara=demitasseerasuresteppingstone
randa=pentathlonsphalanxmaseru
janie=geezdescrymodelled
amalita=expectorationscorpioladder
emera=mothballingfurlongyups
lanna=mismanagingdistortedgethsemane
silva=minicomputerboeotiatanner
tildy=overachievernoisingspringiness
fionnula=gametesdelinquencydehydrated
olive=courtlinessromanyhandpicking
kylie=dryerdixielandstempter
chloette=modularmenhadensgarnered
codi=dissectelopingcutback
cordula=anthraxmethanolinvalided
aubree=predisposewiltonasset
liza=vignettesonlookersfrigate
britta=tempersillvalkyrie
dorothy=costumedwheelbasesroguery
mable=misfortuneadmittedlycagily
sofia=gnashesrabbinicallengthen
giuditta=bounderloadersqueamishness
alexi=recoupbesomsidebars
georgeta=knavehominyattended
christye=hockneychestnutsmicrowave
janel=gooierrevengeleicester
nessi=kropotkinlevinedoughtier
nolana=spoonsfulasidesfaeces
carena=drillselectronicaindependence
vivie=bobbyinstitutesplagued
norry=bevelsbassinetssedan
katerina=cinchedlulupreamble
lynelle=cartonsakitatacitly
esta=rejointuckedlancelot
ingaberg=unloadedjeeringlydistracted
alvira=fitnessbailiffalfonso
rani=storminghamstringingdiscomfits
charin=brackenbrickbatexpounds
bellanca=virgulecreviceunquestioning
bel=cassavacotyledonunconnected
gunilla=violinswiieaton
tobye=applicabilityfailingsynthesizer
winnie=snellpolliwogsuperman
isabelle=aidemachinationsleftovers
philippe=misstatingirritationsdieters
lorrin=editioncairnsevacuates
dona=santactesiphoncentralisation
friederike=corruptnessoverridegamier
dee dee=exhumesmilitarisationteasers
sela=malleabilityobversefreight
agnes=misgivingyankelitism
timmy=febrilestocktonexoplanet
nyssa=flummoxedparquetryostentatious
ethelind=friezesubterfugeamericana
arleyne=defermentsjeeringdogmatically
kippy=redemptionfruitygrady
tana=cupcakechaisesnortheast
hedwig=rebuttaltickledmodellings
wendeline=speediestmillardtwofer
kimberli=mechanismstolyattitravellings
cherianne=sarahpinholesdevalued
bari=squeakinterdepartmentalupcoming
malia=debsusenetsubverted
kerry=unauthenticatedscapegoativory
anabal=disparatesafeguardinghysteria
phyllis=paragraphoversharedfrieze
constanta=chesspositronbumpkin
eada=he'dworkflowheriberto
nerte=snaredthievishinbox
ardene=portholedispossesseselectronically
kirsten=alphakerriimpeach
babb=favourinitialisestactile
pet=relaxationpapoosesswordplay
aurora=soothinglyogilvypratt
florette=amishchattanoogaincise
cosetta=crowdrefreshmentthey're
truda=peleesacrificesexpansive
keeley=interludedbonelessbelgrade
rachel=devoiddeceivesbronco
charmine=indulgentlyseraphimphlegmatic
marney=felicitousbusyworkorating
drusy=gamowteatimegranulate
debora=talmudlucilegenie
rianon=syringesgimmickseducator
wilhelmina=circletascertainablepillage
magdalena=disadvantagedutchmendeciduous
suzanne=approximatingkublaimutes
elyn=caressdiannnaphtali
robina=manègeshamefacedglaswegian
gennie=disembarkssubwayssnot
elspeth=aweighexampledfrontrunner
veronike=curbssnubcontractile
joy=presentderailsblockhouse
jacklyn=ayyubiddecadencepoppins
kristel=maintainsdinnerapproximated
danice=outbalancedbreathrashes
florie=aestheteafloatcoy
kiah=carranzagonzalezinactive
maggi=caterssupernovataney
shea=crumbiestconducingstupider
nicky=boondogglenonbelieverborn
clarice=licitnemesesnaiver
dedra=pocketeddepotsdimming
perrine=dislodgesannapolispunctuating
joceline=honestestjosiahputin
felicity=dizziestdyereconomy
cammi=snitchingriyadhzirconium
libbie=yammeredscroungedhoffman
jacynth=inertiaolympiannatalie
wenonah=pamimpulsingcorny
dasi=slobcontemplationberra
frankie=brainstormingquaveredletdown
terrijo=billowcasanovavans
kissee=clearlygetawaydion
monika=allysonchampedshould've
delcina=pedigreeniftiercorpulent
albina=adriaticnumberslakes
natasha=marinesroquefortbookshop
lorine=panelgemstonehistorian
sonnie=wheelsjoanneviscountess
merline=wealthierroutinetangles
domeniga=carnalganglandeliminations
adela=puckertransfersfremont
lotte=aldermanhighchairspremised
sarina=mailingoverachievershipping
rachele=courthousesfatalismmasquerade
eleanor=tonightteakmade
mame=inferioritysputtersdetritus
teddy=corneafillipmaratha
shela=malfunctionscabbingguessers
mathilda=hemstitchesrudestlinkage
terese=estradatutorsstationer
diahann=larboardscorrectionalbison
lil=cyberspacesnowmanshopping
stephana=damnationnaiadsombrero
brittan=boodleszingerapogee
colline=spluttersapportionimplacability
jenni=scorerstretchbetide
dorry=transportyahoonewel
dotty=ophthalmologistcrazierpolygon
olivia=seismographdemotedchamp
katuscha=mendelssohnvagabondedchap
dana=listenerdominationoverstated
kissie=wirelessescoevalmaxilla
fanchette=ruskstotalcorruptly
josephine=affectedpamelaretrenchment
maurizia=empathyrepressionthwack
lurlene=rebellingchasteryeshivot
tarah=spiritualisminternalisesindelicacy
patty=exemplarmarionaccusative
ginger=robberwelterweightobesity
letisha=positronsfootworkamuses
teresita=revivesemacsrebirths
charil=briquetforeshortencanvasback
zuzana=relydowellingpeddles
aprilette=rescissioncounselledtinsmith
romona=infatuatesstoogestightens
doti=jatakaclickablekenyans
claudie=furzecomposedtrimming
persis=spinaldesperadoeslucas
daveta=idyllicpowhatanpictographs
aigneis=bedsadderleykringle
clarine=pepperloosenedfixedly
april=tingsdorisecologists
lynda=lionessespestletests
charyl=hausarummestlode
cornelia=sashafoiblesawards
phelia=cloroxsuccinctshevardnadze
liana=erickniggardsibices
devonne=seedsatherosclerosiscolloquium
gertrude=inflectswitcherynorthwesterly
dorrie=pearlsworddelmonico
queenie=kickbackmidgehireling
sophey=bridgeheadslowestcognac
paola=tryhairpiecegrapevine
thomasina=lambastspickpocketsinsulation
dolli=eligibilitypricesvulgar
beverly=divergedmendelianpotentate
ellissa=cavingsmitingpeony
sandra=wrongheadednesssurreyfidgeted
rosalinde=broadbandplayfullyfukuyama
manda=artmushygargle
annabell=thwartedelvismohorovicic
lorenza=shadowiestmilkinessintemperance
kati=mitziandromedaparaguay
marcie=janglespilafstencils
tonie=buddingsritualgermany
tomi=eggshelleffectuatescatastrophically
nady=hellespontdiaristgraciela
mil=beatrizmenanderdisc
merralee=mirplacentamagistrate
edna=exactlyretroddenrustle
justine=autumnsheadingproffered
brear=fosteredlayoutlegerdemain
gipsy=kenyattainfinitudeothers
carlina=ebullienceamenhotepbedroll
frederica=anchorpeopleunwrittenpart
jeane=roostervolleyballschekhov
laurena=nosywhisperingfetchingly
vitia=troopermantrasilicosis
raven=cheepingnumeralscald
gerri=penalisingsuperpowerscover
dulsea=transiencegaybeacons
ag=bongoscoworkerstyrannosaurus
christal=balminessmurderessexpect
fenelia=islamicagendasatchel
elora=sixthsexasperateddashing
dayna=drapeddecantersday
valerye=southwardrecessivefeistiest
addi=ashtraysrossmemorialised
fina=herbartsulphatebroncos
torie=subteenislamicfraudulence
christabella=sedatelycatulluspicketed
cecil=primingpandorajehad
virginie=boulderreordersviols
melloney=astronautbooziestbeatifying
kamilah=plateausuperiorspensions
nadean=rusticityconsomméthreaded
aurilia=sandhogsameslanmurrumbidgee
trula=flakestoreadorship
annadiana=scrunchesdoyenastonishingly
merrielle=anubissealsmegapixels
taryn=ivoriesagilevigil
elli=baxterregularlordly
merridie=humidifiersaestheticsforswearing
dawn=izhevskhalvedhauptmann
margaretta=entertainersmindingmyna
susette=tristancausewayforbears
carry=buntbunchedadana
peggi=restructuringmontoyanancy
cherry=bandanasscythingmashed
jennica=shamefulnessaddendumafterbirths
ynes=revaluationscabbiergay
cathi=snapmaddensenna
jaine=spacecraftsantibodiesvivian
rubia=unfriendliestpostdatingrearmament
carroll=hijackingcraziestdifference
nicoline=riboflavinfrequentimpregnated
loretta=cadenzasflagstaffleningrad
joey=eugeniatablespoonfulleukaemia
drona=stoogereverberationpreventive
bevvy=hospicesheinrichlulu
josefa=passelscaracascurriculum
emalia=tonsinequalityanaesthesiologist
sadella=sedulousminxespattern
allx=shipwrightexpletivepredating
britni=crumbmountaineerslipreading
sibylle=peninsulardisadvantagediscounted
johanna=obadiahneocolonialismauguster
danny=gamekeeperlimpkonrad
alanna=patrioticbiannualpunster
dorelle=rivalriesprognosticatorworkfare
anette=drollerycaucasusintravenous
rebekkah=aileronsdamndestglittered
benny=polynomialindifferenceallegro
kania=palesdisquieteach
annnora=nolanflightyunnoticed
imogen=partridgedesiccationcyclone
ardis=youngdisconnectedspoor
larissa=paramourpenthouseeviction
ronny=bardspaderemotes
gerrilee=llanocorinthforesail
celisse=sanatoriumsskinnedorthopaedics
sonnnie=bowlingyawdeclarative
marilee=beatitudecommitteebaxter
emmalyn=veblentellcoach
audy=synthesiserinterruptingpalliate
jaime=maitreyareformatoryqueening
elena=welchedelusivelydumas
ginnie=honetykenearing
marylynne=neoclassicalminibikepromiscuous
theresina=refinedhurrahirradiation
georgette=persuasioncoalescespilloried
maggy=mangocommonwealthetna
sybyl=backwoodsstrainerliege
ami=dependenciesrosenyerere
sissy=albeetiptoesinvalids
florence=gratifiedbecalmingunruliness
leoine=iconraggediestfieldwork
caro=clarifyingsoundproofinglobsters
timothea=chunghansompsychosomatic
corly=expressionismdisguisesextraverts
lettie=wimpleswitzerlandoutfits
rosamund=electrocardiographsbarbecuehypnoses
polly=tallyhoingambivalentlymiddleton
mellie=motivatingsheikhdombesides
clarita=cubancroakavon
christy=surveyorblimpvictimised
brittaney=assigninglaboriouslyextort
fern=privationsinspectsgaped
marketa=baguiocountdownslatvia
caresa=nonubsbellyache
denna=elvirapremyslidglutinous
marti=entailingruchbahvetoed
eadie=victualobsessionacts
kaylyn=compasseshydraulicallyleeway
valentine=schussunloadedtelescopes
shelly=ayrshirewaldheimnabobs
lilyan=axedlionelhals
chiarra=shuckrasputinforeshadows
aurelie=stipplesoverlaity
mair=hissedvowelsbelligerence
jo-anne=complacentlyiquitosmormonism
aura=plottingvotariesclunking
saundra=dishwashererewhonchaffed
cassandra=tincturesibilantnostradamus
darell=tutorsscrabblemonarchism
ethelda=chungkinghogarthflimsiness
cary=jackrabbitperrierworkmanlike
tamar=wanerhardgiggled
bertine=spearheadedbiochemicalchucking
larina=japedstineasbestos
lydia=orbisonkeybindingconsortium
carmina=dentalsoundinghomicide
jessamine=relationhirsutetautological
illa=miniaturistsfinalistcoxswains
kenna=stragglerstenographersvexing
agatha=distancingwhamsargonaut
sally=holisticpadcuckold
dynah=gregoriomoparalleling
moira=guyedresurfacingresort
sabra=wormholesvoidedresource
ninnette=petersscepticwalkman
alexine=tudorodiumstrictly
timmi=bustedtearymightiness
aurea=magistratesnasturtiumdrawl
cindie=hittersinusitisplate
conni=rebukedpensionbluffs
sorcha=gurglesmacyscraps
linet=reeferschedulersrescission
giulia=overspecialiseddickensteasdale
jenn=washessyphilisrevenge
janice=acclaimslapdashpolling
tessi=inhibitionsartistquantifier
danna=balsascuriositiesdemocratising
vinni=credentialscotdoodle
vonny=genuflectiontemperamentswallowed
becca=shortsnowmobilesensitised
sib=woodlandslistercooties
petronella=extremeunobservantsprawl
randi=wimpiernashvillepolicewoman
cathlene=limnssewersrebus
lauretta=convoyingsworeinaugurated
stephannie=arenasimpalementcreamer
lindie=appetiteseconalbriggs
dianne=presagequadruplettumbrel
olivette=cornucopiapetulancechianti
zaneta=bismarkquadricepsmessiah
bria=pioneerweakenedtheiler
fredia=conjureroutvoteluann
petronilla=pikingintransitivelegerdemain
berget=tangodecorumcontrapuntal
kerstin=interchangeablemolecularrefutes
sharleen=transcendentalismperoxidesoaring
nichol=impairingsuwaneedodges
otha=obliviousdantontomahawk
maryann=peepthawedwoodard
prisca=tastiersterilisationmaintained
rita=pantsuitroundhousejubilees
vilma=storedjusticechesapeake
christel=phoneycronusacclimate
marabel=denmarkstarknesscaste
aurie=prodigalhayseedannotate
petronille=medullaeschlemielpenitential
luisa=spongersergenighthawk
christan=recapitulatingliftoffmylar
blanche=aptitudekittycontrails
gracia=undertonebloopercelibate
ofelia=hassledhelpedcompartmentalising
miguela=pawneelibidoboneless
la verne=tangelounicameralnightstick
adele=powwowsscarcitypetition
alexia=mesdemoisellessergeantprecognition
felicle=palatesribsaddened
shirline=unaccountablewelshesmalayalam
amalle=eyeballedequationssequoia
dreddy=firearmforgemoliere
cheri=bicfalliblybloods
rivy=establishmentpalmyrareforesting
gloria=chaisetrimspurgatory
rozelle=feelfjordjohannesburg
kathryn=cremationliverpudlianstolid
nonah=entreatnonproductiveaflutter
lyndsie=henchmanrowehorror
shaylyn=puckettfaderehearsal
lily=sympathisedchockedyahoo
brita=intensifiesexcitementarmando
jasmine=teazletabathasweatshops
elsey=smartphonesmatchboxdeanne
eula=joyfultowellingsroadway
sisely=allianceequilibriumbeatniks
lusa=ankhmurrumbidgeewangled
thalia=magazinesunscreenmagnifies
carma=unitysuccumbsnatchez
ebonee=absenteeneutralisedbung
kalli=continentalsmozambiquesolicitor
rebekah=isabelcarrotgamy
dorette=kindmccainemulsification
amelia=greedycateringsalaciousness
charline=semiputterwranglers
lu=metingslaughtercoefficient
gaynor=maximlockelectric
tedda=abjureclementglens
agnese=implementableophthalmologistsquintupled
sadie=unreachablelottieyugoslav
prudi=lourdesbillionstolypin
mona=savannahsawyertinseltown
dyane=skidtranspiredhaldane
brittney=surchargingrepleteinjured
laetitia=direstgirthdeng
gilligan=saskatchewanfloaterheedlessness
ardelia=pyrespugnacitydieseling
nonnah=mergerstereotypeconvalescent
gilli=rutancrossroadsgeo
emiline=scramsluggishnesschipewyan
faustina=validnessglamouringbrain
krystle=undulatingfirebreakvulcan
cristabel=drawnsimulatetestosterone
allie=briskingpresumptuoussunbathing
mirna=boggytelecommuteddwarf
constantine=shorelineslummoxdominguez
chelsey=advertscariesdesdemona
vikky=countedchanticleershearkening
marcy=topsailmussorgskyweaknesses
cassy=puffedcranniesskiffs
phedra=impedesrudycommoner
fleur=goethalsanemonehollie
rivkah=outstandinggravitationalbag
janka=thulequadrilateraldiscrete
minnaminnie=preregisteredcabbagescurrants
kai=fiddlingchickweedremainder
winny=enthralledantidoteseventuating
dorine=bauxitepailwhitings
emeline=blowgunbanalpassport
doris=whamsoverhearsblock
zulema=smackedreporterzachery
kanya=aggrievespianisteyre
meggie=gingersnapvacanciesverbalise
flora=septettedecriminalisationbriar
heidi=mccainpentameterdocumented
giorgia=fizziestairdroppingcalliper
angil=eucalyptusdeterministicpreciosity
leontine=glycerollevyinglionise
nadia=prioryritamicrons
reeba=canticlesimplificationmethuselah
felecia=donnyhyperbolicwildcats
vanni=revertingdellasystematised
estella=landlinepinwheelacoustic
tansy=darkwhenceparentage
paige=raincoatscadappendages
alayne=maduraidissentersjermaine
zaria=hatterpublicisesdynamism
gertie=confessthirteensencode
tally=cubistsmotiveadonis
elga=distastescourtneyheart
rowena=twingeingstipulationsstratifies
tomasina=wrongdoersorrowingcrocheting
nat=villahayesshampoos
marita=lensassertingmayoralty
celesta=sandbaggedtarkingtongutturals
liane=hoopsjibimmunity
eulalie=plateauspyjamasmatrices
lynnett=fractalharmingcrispest
terza=magnanimityabasingrifleman
fleurette=abramsfrontalshutterbugs
erika=idealisticallysolitaireleapfrog
jennie=infinitudeurinedimaggio
asia=filamentedwardianprevaricated
berty=statutoryaidmoorings
erinn=domingobestriddenoutspokenness
devonna=landscapecornetchronically
raquela=aggravatingsunburnendue
gerti=burroughspollockresuscitating
felisha=alepposhinesvivid
cherise=ibuprofenengenderingamherst
olympe=pabstclothingcoitus
lona=transliteratedrampartmartinez
natty=snowstormsripenssalivating
bernette=troubleshooterhomeroomstelexed
revkah=misapplicationbladesgrandchildren
shoshana=clambakequeueshoon
annaliese=navratilovaroacharmy
tabbie=freedmenachebeservitude
lexine=bricklocalityceremony
daffie=privilegesconsumablebelieves
vida=cartspeedsterssapped
becki=tyrocoauthorspractising
dede=handlestalematesattic
ebba=objectivelydefraudsbathhouse
abbe=tendinitisfoistingbutts
stacey=irretrievablycovertradial
olimpia=loudmouthnorsemenorange
edythe=hypnotismbarehandedrearing
kellina=foxhoundscomplementaryclan
carmella=underlinedbrotherlinesssheath
rubetta=tomcatdaylightspenology
ella=colleenrecyclablesbrandeis
eyde=blackdemonparenthood
bill=supplenessswallowtailsummertime
minda=moralisespatronagechoosier
cristionna=jackassmollymelon
cynde=wrestentrustedvolleyed
mureil=livestockorinocowelted
cass=galleonsalbacoreneonatal
marice=cobaindeodorantresorts
karmen=subtotalcheerpaula
rivalee=sheepskinshyaenamanaus
katheryn=huxleylegislaturepanics
tootsie=pulletlegislatinginviolability
goldie=kampucheaunderworldssleepwalkers
domini=simulationssuperintendingbreeds
jackqueline=epimethiusinflammationpedometers
layney=viciouslyrickyknapp
blythe=punctuationparachutistsmahatma
ingeberg=nightclubsgrandchildrenfood
alethea=backwatersuspicionthrums
cindra=abracadabrapuscornbread
tim=unregisteredprefigurebulgy
emylee=reprieveprofiteersbewitching
arlinda=nailbrushesutopiasrefuel
marie=unfrequentedtestosteronejudge
ernestine=detrimentssituateabstractions
nanice=truculencestemmensa
nissie=cokedownystodginess
ferdinanda=tupperwarecoquettishdandier
alessandra=normalcycheeseburgeraired
aggie=delicatessenprohibitionistsraped
ibby=waysskippingsunbathers
britteny=singlingmalignityrecommends
tammy=shakeupnameenshroud
kissiah=straightjacketedevaluationpea
gabriella=pairingshrinkwashing
estrella=horseflycampanilekatina
phillie=threesunmercifullydialogue
natassia=aldensidesaddleprobates
aleen=perigeescommoneralumnus
kate=felicitydrovemarsala
brooke=ameslangrapevinesprogressing
sabina=cosmonautskodakprecedent
sephira=speerdovesloosing
josefina=upkeepheathsgurgling
jena=broadcastslisazapotec
becky=quonsettackscylla
georgena=effluentselectionwittgenstein
jo ann=discusdissimilarityspokesmen
georgeanne=catalepsywordsexagenarians
tiena=scherzosuperstitionsdispatches
brianna=sassoonphysicianpatch
arlee=intermentscootiefaced
cherice=haymowarmpitdeportation
mala=activatespalledmali
pammy=profligateshoneydewdisservice
lina=mikoyantommieweightlifting
floria=opulenceexculpatesmisdirection
sher=hunsomnolencereactors
rikki=interpretersthemecyclamen
sibley=peterfloridamarketplace
codie=debilitationalphapaleozoic
connie=slashbrimstonepopinjay
basia=typhusbuccaneeredclassified
mirella=ancientestproprietariesgene
maitilde=mayflowerdiscreetlysyllabication
lorne=mantlingwestwardssluicing
lonnie=rosinessdrillcomte
gayleen=commencementssobrietyspecifiers
adaline=dividendssocialitesfistful
suzanna=colbertcraigfredrick
vivyan=phooeyfructoseprocreative
pearline=craftilyednabundles
angy=ovenromanssparsely
elsy=bowspritnewsreelthimbleful
gratia=calvarypolitercomputerisation
maryrose=civilisationobscuresabram
daloris=undeservedlyasphyxiationshamlin
zoe=caseloadsbustingoverdosed
lynsey=amphetaminenettsvestiges
philis=fearingohmbuckner
jolie=aldermenmotorbikeapposition
bobbye=pickaxesmenelauszither
gussi=hightailedmethuselahcaprice
lorry=furrowsmellierquid
donica=disabledoffendingminimalism
stacia=archdeaconunlatchcaller
ofilia=rovedsubbingbighearted
odelinda=brawlkarachicheerlessness
shanda=rumbapeppedexcoriation
tressa=recompensehumanitariansbootee
caroljean=latinobesetoutlaw
margette=daredevilderideregistered
sashenka=tinnydietaryrhapsody
lynna=courtlinessmiltonicunderachieved
brandie=lowestbenghazitlingit
evita=selectmanappropriatingprison
melony=millsmagpiemucking
farra=truculencemultimediaapollinaire
gillie=delgadocalliopeenlightenment
georgina=topsyexclusivesdrew
ellen=intersectedenfranchisingfollower
christean=chanceryxylophonekiddo
pam=goferwieldedpowerhouse
donia=squabsplayablehandsprings
maudie=ragamuffinmanoeuvrabilitysmuggling
bamby=standoutsbetlosers
oralla=enchantressesincidentcarpetbagged
masha=terabyterosecransbruce
merlina=staubachsecretariestriplet
daphene=turkeystaplesthesaurus
courtney=berenicecrammededdie
teddie=hypnotisingslapstickoceanus
fionna=beerbohmslurpsflightless
crin=tougheneddemilitarisationbarefooted
aloysia=drizzlescellularaccrediting
kathleen=imperiousnessspenglerianthor
ardelis=shoedtamekamedallions
tomasine=spurcrevasserefinance
maridel=shuntdocumentedtoned
cam=landscapertamperingsufferance
lilllie=critiquevestaoverproduced
kelsy=onustardypeale
clareta=lyonsmurillotimbuktu
blake=bookshelvesobstructionistloopiest
laureen=friedanguaranteefeathery
ernaline=whalespasteurisedaurangzeb
tawsha=cryptozoicdebrecidivist
gerry=quartsalaciousnessbuckyball
gerty=sophistsgarishnesstelemarketing
lani=triflermidyearconnectives
federica=neatnessfractureanatomies
sidoney=scopesmicrosurgeryentomology
brigitta=walleyesulcersbrakeman
corabelle=pungencyvolleyedarden
emalee=crotcheslaceyinseminate
aggy=bucksgarbagechieftain
mel=leashedmafiastalmuds
jobie=crplanktonexpended
yvette=bertelsmannmarinespuckers
dorolisa=clapperprowsrevere
virgina=slightsswindlermelanges
carine=bottleswebbsandburg
danni=callinguncivilbombed
betty=icecapjunkcongenitally
genvieve=theresarevelcrochet
joanna=centrepiecesimplifyingextras
nola=soothemisbehavesimaginary
amberly=sallyarroyoscoolest
corri=khoisanrabbleexecutable
bride=braintransiencemilieu
kalila=paymasterdaytongantries
corrinne=gulfdeterminantclang
babbie=seaweedroxanneunmerciful
xylina=foerandomisemann
sibella=allancroesusdominantly
berry=shelflavernsomersaults
rosemaria=approachreemphasisedretell
megen=realtroopertinker
alameda=hobbesscrapconsciousness
wallie=margobumptiousbiggie
gladys=deconstructionswilmingtonthermopylae
remy=tonnageprivatisationkiddie
jillana=lontrailingdecorated
ashley=comfortsblenderdashed
nikki=threesomesvalentisymbolism
augustina=silicosispythonbolshoi
teri=jarvisunrestrictedfiretrap
janelle=eatsdedicatedinventories
gypsy=malletnailbrushbicuspids
misti=fluorescentrejectingbenet
odelle=grufferpentaxepoxy
winnifred=pocketknifeuneconomicsuckled
jonie=bessbuchanandravidian
doreen=beckydarkenedhypnotism
robbi=drinkeradjudgingimplosion
lola=gogolpersimmonsanticlimaxes
florentia=wardroomcautiouslytrimmed
eleanore=whimperdriftwoodcustody
midge=ploddingsclefparole
avrit=nightmarishreginaminuet
adorne=palaveredanglicangrenade
wendie=jurorshaematologystudies
beverley=notariesclausprostrations
renelle=oiledgushesgrooming
leeann=specklerigourwines
trude=ballastingquintilianindians
jobyna=rejuvenationfrankfurtwhites
fernandina=gobletdimwitmilking
madlin=homewardsexituncivil
gabrielle=officiouscateredboxcars
jewell=cahokiapromenadedgrand
jacquie=rearedmajurosepoy
ddene=burredsurpluswinter
lise=committingbrightenstelevisions
sheilah=hypersensitiveiranianunfeasible
fred=lockinginsoleextradited
liz=okrastemperadiminish
marcia=they'dacrosslent
torey=thirstingpoundstephen
jaclyn=atomscarierstalk
tracy=germinalbandagespsychologist
evvie=shivertaskfunked
rosamond=bruisedodgesmarco
helyn=ticketingnarrationstrespasses
cariotta=mallownicolaincomparable
ivory=brusklypreciousnesshugs
laurel=gemstonecompromisingfey
laryssa=deviousnessintensifywoodrow
pia=costarsalbreflexes
debbie=pankhursttranscribingtrill
tersina=servantbaanotepaper
almeria=misdemeanourfezesdented
rafaela=raphaelremakewindlasses
minnie=thwartingsmiteprod
camellia=transactsknobbiestlabial
jannel=weesentailedhaunt
lanae=lodgemarxismboru
luce=inconsequentiallyemaciatingstill
marga=decreasenoladestiny
bobbee=headmistressoerstedmamet
aggi=reservoirscattycerebral
sileas=stormybosporusmistakes
mercie=anthropoidgonadssubstantiates
janeen=ardenworkmenpresides
aloisia=wignertangeloinfectious
hermina=ghostwriteabolishedcoffer
doralyn=firebugsacousticmueller
claudina=miscellaniespagesfalsified
molli=televangelistblunderbussinterpolated
leyla=smackinganusmelendez
shari=pinkiemiscastssuspense
nettie=pantaloonsdaguerreotypestransmigrate
stefania=golfcandelabraconcierges
nerta=poloreincarnationporno
dru=chourobertaamnesties
avivah=unseemliermisersuperseding
marje=stacioffalpepys
guillemette=musicbirdcagesuseless
kaye=farmyardcombustiblesswitched
kassi=thousandknuthbetaken
tiffanie=trafalgaremperorsabductee
joleen=atekampalabeauteous
melisent=perjurermarchesportent
kari=shimmerheartrinses
jenifer=andantezhivagocupola
diandra=praisechattinessprocrastinated
karil=oatmealfacilitatedgeographer
florina=madeirasgeedmoreno
malena=pictographssnobbishaccessory
rici=disgustsinterlardedemos
clementina=absoluteswaxworksconfinements
jemima=nuclearbackpackssereneness
franciska=tequilaattackedcommemorations
dionis=reappraisalaffectingmilitia
ursola=prepareslistenersflowery
kerrill=ranchingdepilatorywimp
velvet=evaluatingrhondawhopper
jemmie=lampoonnathanielmanilas
lyda=herefordexorcisingcalvinists
filia=comportsfullerten
wrennie=bearerdivisibilityagriculturalists
brigit=ibliskanocharbroil
cindi=roundaboutsprohibitionkosher
eirena=bogeymanwallabythrombosis
talyah=centimetrescranemississippian
kalie=quicklimeauditionweber
katie=rabbilindenslikeableness
kellyann=terrificallyprecariouslyreachable
jocelyn=scintillaploughedunconcernedly
rozamond=enduredinconsiderateconditioned
ingaborg=fourierimpedanceuncultured
wendye=gaffeslooneyiercourtier
elise=renovatorsgladesicknesses
drusie=curveoleandercondensation
collen=accusatoryarmisticeempanel
lia=influxodysseusapprenticed
junette=impolitelylavonnedrama
alika=statesmanlikeinitialiseoverbear
cecile=kievsteinwaynatasha
melanie=novellaweltertorpedo
kore=gipsiesluncheonbarbershop
genovera=demilitarisingrepugnanceflatfoot
dorene=trouncelockableacrimony
petra=stockbrokerslarynxrescinded
nicki=stefanielafayettecubed
bella=softeningropeprudence
jonell=materiallybigotryturtleneck
celle=playerreverentiallambed
abigail=mulberriesrevisedrewiring
lacey=unintendedarthriticsbrit
verena=necessitatecozencretan
guillema=imponderablesemptierrefrigerant
constancia=rescindoutlaysthirteenths
honoria=doricelocutionkathy
klarika=yankeddepopulationdromedaries
analiese=admittedexpressivelymanifestoes
arielle=housekeepingslopsetback
horatia=acmessummonsreplica
tillie=visualaxialbushwhacked
lanita=tithesimsuccinctest
caryn=agogdoughtoastier
augustine=chickenwellercandidly
mariska=associatedflemingwrench
corrine=rodentsbaccalaureatesblissfulness
bette-ann=karynfalloffswaldorf
erena=agreementfearlessnessoakland
cherilynn=tidingvacillationadulthood
marsiella=coopmarksindicative
ezmeralda=haystackbiographycheesy
leia=westernsnoopydemoting
irita=lacierlambdaslovenian
pauly=exhibitionismveritystalkers
desiree=furtivenessgazellegarrotting
margret=retailerleroysignificantly
selinda=recuperatingshortbreadgap
valina=plunkpresuppositionspepsin
deidre=foolhardinesswainscotreadjustment
penni=priestessesannulsduplicating
josy=anticlimaxswankedcubism
ivette=robersonmolltupungato
ferdinande=fleecedsnuggleiliad
pearle=affinitynonconformistrationalise
janifer=escapismcommunionwhelps
lorita=tommieweerquickens
aridatha=caregiveruncertainlycircularising
eileen=penguinssuccessorclark
bridgette=profligatesactipsier
lark=claspambiguityskyjackers
ingrid=bilgenetherlandsosprey
viola=livestautnesslover
cybill=studdingjournalsplacated
jeannine=raccoonsdesignatingwomanlike
correy=arbitratedunlikelihoodtwinge
nata=acclaimingsandboxlandslidden
mommy=millinerstrolleyerects
alex=factorinlandunderage
danica=romainesubsistredress
vivienne=gleetediousalsace
denyse=salvationdvorákconservation
karla=hallowe'enflowedmavis
alison=endureshallucinogenicpillions
penelope=freelancerhorridlypontiac
amanda=lonevacationedgrindstone
lavena=hellenismsbrimmedbehold
alia=spencerhidingdiplomas
betteann=moroccansvignettingclaimant
rosabella=incentivestillbirthpropagandist
elbertina=hokiestmargaritoarresting
mattie=callingschweppestang
ulrikaumeko=referentialshoresduellings
abby=inherentlychroniclefiords
katusha=caloocansiftonslaughts
barbette=mordantbraveryautomate
carolann=yourselfhardbacksheadrest
maurise=gentlywhiffsbadminton
alisa=wiggleblindbooting
camala=rosenbergdisbelievingchrysler
arabella=subscribesimprecationpaley
jeanelle=ilugubriouslychemises
amata=shininglandsattimorously
kaila=invitinglyrougheningodourless
briny=instillheadmastersnabs
sara-ann=reassessmentclankspetals
quintilla=preliminariesunpredictableslope
danell=chileastirpaling
philippine=zombiessanteriaquarantine
henriette=sacexitmascagni
rochella=gothssplutterlankiness
timi=formattingheartensclamoured
sheree=dealereloquencebestrid
phylys=scripturedogfishesxenophobic
henryetta=dispatcherdeccafafnir
ursala=cleatpancakesdriver
xylia=flaresnettsteamroller
tobe=oustedlanguishedtong
maddi=roastersnicklausthwart
aile=vacillatesginnycosponsors
gina=gulpsbereavefoxglove
aileen=highchairviceboreas
malvina=norsespirearizonian
matilde=coequalgibberishalliteration
wenda=satchelhomesteadwholeness
clari=atlantissimsharvester
cora=electrocardiographpaltriestmanchu
joella=marigoldsreunificationcontiguous
kippie=stainlesspredictablyparenthetical
maren=flueworksheetnook
bee=galloptinkertoylowbrows
celestyn=bo'nsfrierclaire
vinita=lapidarieserectnessnepalese
ardine=brinkshawaiiansantimatter
berthe=coupletonnagedyer
judye=honeymoondefieslawful
inesita=pacemakersqueezerkamehameha
lari=fauntleroybodywretches
conchita=telltalecapacitorsheadquarters
trixie=fundamentallyhyphensmencius
violante=romanticistslushnesshandkerchieves
correna=senegalbilbaofilming
marlyn=honeycombmolotovsweatshirt
erminie=antelopeswispsawed
jennine=garbshollowayflatters
carlen=paperworkdowagerswalgreen
livia=faultungodlysecrete
aubine=floyddenimcodependent
silvie=hearsethirstphloxes
gwenneth=midnightadmiraltysigmund
francene=humiliationutrilloimelda
katharina=giftingfiordteething
gui=goalpostpivotingdiscoloration
lavinia=brazilianwolfebony
sammy=protrudecheekyacks
nikolia=hiresgardenercompares
alissa=maorisfumigationboy
dorothea=elvinlizzycracker
clea=golgothaguestedstrep
lyndy=byzantineminiaturisestrashiest
wilow=overhaulingcustodianflyswatters
wendi=affabilitybushrefectories
gael=vocalisationsrenaissanceantichrist
jsandye=overexposesgeorgettegrungier
jessy=kerryprostratingiris
sacha=nihilistsdefrayalprobationary
carlota=studioshirtskith
angele=dynamitecaryaseptic
druci=oxidisingbereavementfrigga
wynne=permutedmasonsfireplugs
minette=enzymesaccordanceconcatenate
margaret=potencybunionssee
gilemette=muskellungesolutiontramping
shane=slappagecornerstone
marielle=snowploughsceriseloots
gabriell=dollyexcessivecodding
lauren=nicelycoalitionairdrop
jessika=computerisecarillonsaphrodisiac
ania=supernovaelosefunnier
janaya=lilianabinssevering
sandi=squirmincarnatesletup
esma=supertankersgorgonzolanape
avis=dungwapitiwatermelon
ailina=coilsbotanyarchaeology
tonya=lopsidednessrheabehalf
gabriela=adroitlymolochdesire
alicea=stilettoratiosscribes
robby=annabellesimonchattiest
anna=reyesfoxholeburlier
ninette=glitchbastilleunderpinning
benedikta=delaypummelobesity
fidelity=kilogrammemergersenshrouding
jilleen=tiresomesootiestfisheries
madlen=infantphaedrawavy
lesly=radiusclearinggrower
roxy=atelierclearasille
rica=parterreshomeliestrivet
tabitha=speedupskyrocketunderneath
betsy=hectormisbehavingdecorative
agata=chamberswalrusapolitical
lynnet=extirpatesintransigentclient
binnie=incarnationetymologistcalve
teresa=furiouslycomeuppancewarsaw
moselle=angerphilistineoverreaching
daile=dirgehoroscopeskype
gerianna=stoppingvocalistproportions
yettie=conquerabyssiniasourpuss
madelaine=mademoiselleswusswimple
clerissa=cosigningtidesporadically
kath=enfranchisingsmellyhomeland
jill=melodramascommodityloraine
siana=whirlingtruckersjagged
berny=hangarhemstitchedparboils
ryann=cabralkinneyrainier
kay=balledmuckyfishwives
nanete=tabloidcheetahtravesty
marya=afternoonwoundermilne
jacquenette=rashnessbloodystraggle
lorie=roadworthycathrynpolitically
odette=cagyveblenbuttock
charla=fretdisarrangingwaffled
kym=jinxescroissantsgatecrasher
elianore=veepmetaphoricaltrammed
aarika=cynthiageckocovey
kristien=transmutingjackhammerphilistine
helaine=careycollegevoodooism
caril=redheadtarnishchallenge
arabelle=abhorunflappabledusty
rochelle=dictatesaversionmoraine
mariellen=fedorabegsdoormen
raphaela=photostatthimblespreeminence
stacy=magnifyofflammable
merry=overwhelmedoverburdenedcausally
farah=radiogramsconstructorfronts
aleece=fervidlysevillemachining
casandra=rhizomesworcesterswindles
pippy=residencesamazonsnonresidents
reba=sailorshaemorrhagesmaturation
rosanne=armamenttribunelighthouse
alysia=inconveniencingskyedsitting
zarah=aerieyammerconcerto
viki=buckramgentrifieddishonest
kiersten=laughterdiscreditcomprehensibility
orsa=keypunchedreroutinghibernate
yolanthe=banguisavvyantiperspirant
valera=reserveterritorialresists
corrianne=executrixtranscaucasiashevardnadze
charlotta=navratilovacornflowerfrost
jenda=synergismmisjudgmentsboo
myrna=pothummingbirdgehrig
jobina=cabanabrowseaccrue
elfreda=denouncementenormouslysagebrush
sherrie=artificersrasmussenschmaltz
orella=seductiveripleyladings
johnna=bedspreadnoondayprophylaxis
peg=scythescalligrapherenforcers
gusti=causticallyboredomoverdo
easter=discomfitingwaringradiogram
philippa=remotenessdeliciousnesswhalebone
carmelle=entomologistsmonarchistlinesman
jessalyn=particularchiseljainism
rosaline=frustratecouperinleash
hynda=recordfrightensclaiborne
casey=kidnappingtrondheimlodge
conny=decriminalisecircumscriptionsgruellings
brynna=socialismprofessorialtoiling
aleta=nunezlitherpair
helge=weftvertigosanatoria
elladine=fearlesslycondoningadvocates
aubrette=mallabjuredobjectors
dorena=impressionhiringclusters
karia=recogniserchilegrenadiers
joyan=swampiestmainsailaccomplishment
hyacinthe=discontinuancesmiscreantnick
lilias=redresshonorificquantitative
juliet=jazzingfinancierstruth
simonette=prepackagingfeedannotated
athene=idiosyncrasieswindincorporated
pattie=statehousehipparchustimed
martita=navarrovanadiumnonproliferation
elsbeth=assemblerbreeziestdeneb
jerrie=rosaliecaterpillarsdisconsolately
cher=emolumentsplayingsextans
madalyn=nibelungscalpelbreakages
calla=kilimanjaromaltreateugenics
hephzibah=beingpalmistslistener
cordi=begonemachismobogeying
hildagard=turnpikedelphinusoxygenates
amandie=discordyuanfamilies
nikaniki=arightunionlocution
cybil=jangleuraniumsurfboarded
evaleen=postpartumsurabayaaccordion
pammie=overshoesdiscoverersmoulders
kalindi=tenurehypocriticallyproperties
candace=recreantinginadvertence
gloriane=disposalstraightawaybeta
alvina=billfreshnessblinkered
janith=foregroundlawmakersrouting
ninon=goodwinmindfulvitally
willow=halloweenformatmartians
hannah=paintworkcolonoscopiesdetection
jennette=nonrepresentationalsceneflip
belva=exorcismsoppressiveasimov
enrika=merrilycootiesoutherly
esther=cottagesdouchemelinda
pru=rothschildhosbuttressed
daffy=oxidestraffickersidiot
elly=wastefulnesscincturerespectably
ruthie=cindersphilipsmesmer
